1,羽肿,9,0,9,0.00621504,0,0.170788,0,0,9,0,9
2,郭顶,26,0,26,0.037051327,0,0.189286,0,0,26,0,26
3,D-Lay,1,0,1,0.001243008,0,0.134487,0,0,1,0,1
4,ゆう十,0,0,0,0,0,0,0,0,0,0,0
5,Gary,0,0,0,0,0,0,0,0,0,0,0
6,茄子蛋,0,0,0,0,0,0,0,0,0,0,0
7,传琦SAMA,9,2,11,0.014738524,0.001864512,0.1699,163,6.31E-05,9,2,11
8,吾恩,3,0,3,0.002486016,0,0.13792,0,0,3,0,3
9,玄乐队,0,3,3,0,0.00832275,0.135322,0,0,0,3,3
10,BowOfAtlas,0,0,0,0,0,0,0,0,0,0,0
11,朱彦安,1,0,1,0.001243008,0,0.123298,0,0,1,0,1
12,DJ,0,4,4,0,0.009669746,0.15689,0,0,0,4,4
13,徐云霄,1,4,5,0.001243008,0.00310752,0.155287,4,1.55E-06,1,6,7
14,蜡笔大Boom,4,0,4,0.00310752,0,0.123672,0,0,4,0,4
15,胡艾彤,0,1,1,0,0.00149161,0.132416,0,0,0,1,1
16,马戏团小丑,1,0,1,0.001243008,0,0.116819,0,0,1,0,1
17,Thud,0,0,0,0,0,0,0,0,0,0,0
18,张蔷,6,0,6,0.004350528,0,0.161264427,0,0,6,0,6
19,燃烧青春乐队,0,1,1,0,0.001243008,0.001243008,0,0,0,1,1
20,尧十三,0,6,6,0,0.004474829,0.168933762,0,0,0,14,14
21,董子健,0,0,0,0,0,0,0,0,0,0,0
22,丁于,0,1,1,0,0.001695011,0.128662347,0,0,0,1,1
23,上海交响乐团,1,0,1,0.001243008,0,0.001243008,0,0,1,0,1
24,TooHigh,2,0,2,0.001864512,0,0.141350502,0,0,2,0,2
25,嘿！！！,0,0,0,0,0,0,0,0,0,0,0
26,王呈章,0,0,0,0,0,0,0,0,0,0,0
27,江南诚,0,1,1,0,0.00149161,0.117618269,0,0,0,1,1
28,玄觞,0,2,2,0,0.001864512,0.12830874,0,0,0,2,2
29,斯琴高丽,3,0,3,0.002486016,0,0.155287414,0,0,3,0,3
30,二凉,0,1,1,0,0.001243008,0.13048607,0,0,0,1,1
31,Shawee,6,1,7,0.004350528,0.001243008,0.177900034,3,1.16E-06,6,1,7
32,abduwalitohti,0,1,1,0,0.001243008,0.128687679,0,0,0,1,1
33,藤乐队,0,4,4,0,0.005932539,0.169591262,0,0,0,4,4
34,ETC!ETC!,0,0,0,0,0,0,0,0,0,0,0
35,BlurryCloud,7,5,12,0.016176133,0.005729964,0.1616633,604,2.34E-04,7,5,12
36,SaMZIng,19,0,19,0.025800186,0,0.189231246,0,0,19,0,19
37,常石磊,9,0,9,0.010772737,0,0.168238024,0,0,10,0,10
38,赵大格,0,0,0,0,0,0,0,0,0,0,0
39,人行道乐队,0,1,1,0,0.001243008,0.124047205,0,0,0,1,1
40,程璧,3,0,3,0.002486016,0,0.151613251,0,0,3,0,3
41,Zhouna,0,8,8,0,0.010517761,0.157229907,0,0,0,9,9
42,李潇潇,0,7,7,0,0.008390305,0.173369953,0,0,0,7,7
43,晴愔,1,3,4,0.001243008,0.004281472,0.13809523,28,1.08E-05,1,3,4
44,Mavericks_Official,0,2,2,0,0.006007872,0.154297621,0,0,0,8,8
45,HAS,0,2,2,0,0.001775726,0.113987569,0,0,0,2,2
46,Krewella,0,0,0,0,0,0,0,0,0,0,0
47,renyi,0,33,33,0,0.02177566,0.199513041,0,0,0,33,33
48,EDEN,0,1,1,0,0.00149161,0.144156313,0,0,0,1,1
49,颜小健,0,0,0,0,0,0,0,0,0,0,0
50,山竹妹汁,1,6,7,0.001243008,0.004350528,0.143997516,0,0,1,6,7
51,U,0,2,2,0,0.009446861,0.148580296,0,0,0,2,2
52,Lonzo,0,11,11,0,0.007830951,0.163687634,0,0,0,11,11
53,「么凹」,0,4,4,0,0.006241676,0.137572032,0,0,0,4,4
54,荣子yJan,0,0,0,0,0,0,0,0,0,0,0
55,Hope组合,0,1,1,0,0.001243008,0.109043164,0,0,0,1,1
56,阿兰,0,0,0,0,0,0,0,0,0,0,0
57,Borgeous,0,0,0,0,0,0,0,0,0,0,0
58,Miguel,6,0,6,0.004021497,0,0.161105429,0,0,6,0,6
59,王麟,1,0,1,0.001243008,0,0.153897981,0,0,1,0,1
60,Showtek,0,0,0,0,0,0,0,0,0,0,0
61,Kit.Tam,0,1,1,0,0.00458783,0.128992446,0,0,0,1,1
63,AllieX,0,0,0,0,0,0,0,0,0,0,0
64,贰贝勒·木森(J-Forest),4,0,4,0.003262896,0,0.156514541,0,0,4,0,4
65,Gameface,0,0,0,0,0,0,0,0,0,0,0
66,杨非同,0,0,0,0,0,0,0,0,0,0,0
67,TooPhat,0,0,0,0,0,0,0,0,0,0,0
68,刘珂矣,0,1,1,0,0.001243008,0.13198803,0,0,0,1,1
69,段林希,2,0,2,0.002320282,0,0.126839651,0,0,2,0,2
69,惊林,1,0,1,0.001243008,0,0.12157826,0,0,1,0,1
70,少年霜,3,3,6,0.002486016,0.002486016,0.164016242,10,3.87E-06,3,3,6
71,昙骨,1,4,5,0.001775726,0.009246899,0.153789347,27,1.04E-05,1,4,5
72,李霄云,10,0,10,0.005282784,0,0.156890236,0,0,10,0,10
73,潜水大象,0,2,2,0,0.005981976,0.154079378,0,0,0,2,2
74,黄诗扶,4,0,4,0.00310752,0,0.13673739,0,0,5,0,5
75,霍尊,7,0,7,0.018696258,0,0.173186201,0,0,7,0,7
76,AngryJaR,18,5,23,0.024099136,0.006525792,0.186637557,314.517,1.22E-04,21,5,26
77,EdJean,0,2,2,0,0.00602082,0.147241434,0,0,0,2,2
78,夏天播放,1,0,1,0.001243008,0,0.161903573,0,0,1,0,1
79,RacoonRacoon,0,0,0,0,0,0,0,0,0,0,0
80,曹翟,2,0,2,0.001864512,0,0.126251637,0,0,2,0,2
81,小白的亚新,0,8,8,0,0.014765429,0.175135242,0,0,0,8,8
82,刘莱斯,0,4,4,0,0.004024979,0.132121432,0,0,0,4,4
83,零点乐队,1,0,1,0.001243008,0,0.001243008,0,0,1,0,1
84,王贰浪,11,7,18,0.018856697,0.004972032,0.189560535,503.5,1.95E-04,13,7,20
85,夏璃夜,4,0,4,0.004215419,0,0.168802873,0,0,4,0,4
86,RAiNBOW计划,2,0,2,0.00382464,0,0.137949498,0,0,2,0,2
87,Anchoe,0,2,2,0,0.001864512,0.137254247,0,0,0,2,2
88,MyTaN,3,0,3,0.020902538,0,0.156852585,0,0,3,0,3
89,R.,0,0,0,0,0,0,0,0,0,0,0
90,GumNam,0,1,1,0,0.001243008,0.001243008,0,0,0,1,1
91,慕寒,8,0,8,0.007178372,0,0.145471784,0,0,8,0,8
92,Ace组合,1,0,1,0.001243008,0,0.111746405,0,0,1,0,1
93,王童语,0,0,0,0,0,0,0,0,0,0,0
94,汐音社,3,0,3,0.003164021,0,0.163482922,0,0,3,0,3
95,旦旦,0,1,1,0,0.001243008,0.085887611,0,0,0,1,1
96,毛泽少,2,0,2,0.001864512,0,0.13933164,0,0,2,0,2
97,张童,0,2,2,0,0.002175264,0.150184909,0,0,0,2,2
98,电鸟个灯泡,7,0,7,0.005141533,0,0.167676943,0,0,7,0,7
99,苗小青,0,0,0,0,0,0,0,0,0,0,0
100,LostFrequencies,0,0,0,0,0,0,0,0,0,0,0
101,茶理理,4,0,4,0.00310752,0,0.173232103,0,0,4,0,4
102,铁击,0,0,0,0,0,0,0,0,0,0,0
103,任舒瞳,1,2,3,0.001243008,0.001864512,0.118514002,1,3.87E-07,1,2,3
104,W.K.,0,1,1,0,0.004866693,0.131934744,0,0,0,1,1
105,DJ,0,0,0,0,0,0,0,0,0,0,0
106,变奏的梦想,2,2,4,0.001864512,0.00207168,0.134791653,6,2.32E-06,2,2,4
107,姜昕,0,0,0,0,0,0,0,0,0,0,0
108,赖伟锋,1,1,2,0.001243008,0.001243008,0.12937544,0.5,1.93E-07,1,1,2
109,星球撞树,0,0,0,0,0,0,0,0,0,0,0
110,颜妹,0,3,3,0,0.004101927,0.143870729,0,0,0,3,3
111,徐真真,0,2,2,0,0.001864512,0.139420803,0,0,0,2,2
112,马頔,1,0,1,0.001243008,0,0.128107551,0,0,1,0,1
113,Danny_AhBoy许佳麟,0,1,1,0,0.001243008,0.113217517,0,0,0,1,1
114,Zaliva-D,2,0,2,0.001864512,0,0.135405992,0,0,2,0,2
115,牛奶味夹心阿尔卑斯,0,2,2,0,0.001864512,0.140439348,0,0,0,2,2
116,小旭音乐,0,0,0,0,0,0,0,0,0,0,0
117,AK,0,0,0,0,0,0,0,0,0,0,0
118,陶喆,4,0,4,0.003995383,0,0.156402183,0,0,4,0,4
119,蛋卷,0,2,2,0,0.004871248,0.148445315,0,0,0,2,2
120,江映蓉,2,1,3,0.001243008,0,0.001243008,0,0,2,1,2
121,哦漏,5,2,7,0.004713072,0.001864512,0.167076872,24,9.29E-06,5,5,10
122,黑峰,0,0,0,0,0,0,0,0,0,0,0
123,兔裹煎蛋卷,1,0,1,0.001243008,0,0.126081158,0,0,1,0,1
124,崔开潮,1,0,1,0.001243008,0,0.126276028,0,0,1,0,1
125,Awich,0,0,0,0,0,0,0,0,0,0,0
126,贰佰,0,3,3,0,0.002486016,0.160275803,0,0,0,3,3
127,谢路昊,0,1,1,0,0.00149161,0.145698779,0,0,0,1,1
128,声音玩具,0,0,0,0,0,0,0,0,0,0,0
129,AbdurusulObul,1,2,3,0.001243008,0.001864512,0.129967135,2,7.74E-07,1,2,3
130,鲸鱼岛乐队,2,0,2,0.004350528,0,0.145828809,0,0,2,0,2
131,何大河,3,0,3,0.016254721,0,0.158296131,0,0,3,0,3
132,德勒闹吾,1,0,1,0.001243008,0,0.084357863,0,0,1,0,1
133,Stwo,0,0,0,0,0,0,0,0,0,0,0
134,万晓利,1,0,1,0.002130871,0,0.137398512,0,0,1,0,1
135,Pink,0,1,1,0,0.001243008,0.13685191,0,0,0,1,1
136,艾格,0,0,0,0,0,0,0,0,0,0,0
137,ambernini,0,1,1,0,0.001243008,0.13560264,0,0,0,1,1
138,JINDJs,0,3,3,0,0.002486016,0.158028221,0,0,0,4,4
139,高夫,0,0,0,0,0,0,0,0,0,0,0
140,Ballrockin,0,11,11,0,0.013212716,0.170520408,0,0,0,18,18
141,雷佳,0,0,0,0,0,0,0,0,0,0,0
142,Aosaki,0,4,4,0,0.003262896,0.143775786,0,0,0,4,4
143,烈雨,6,7,13,0.004350528,0.004972032,0.184425712,50,1.93E-05,6,7,13
144,郑子威,1,0,1,0.001243008,0,0.11778784,0,0,1,0,1
145,啤酒车,0,0,0,0,0,0,0,0,0,0,0
146,J.Fla,0,0,0,0,0,0,0,0,0,0,0
147,Y_xhの柒姬,0,9,9,0,0.007594893,0.157723148,0,0,0,9,9
148,颜韵Ycy,0,0,0,0,0,0,0,0,0,0,0
149,陈珊妮,0,0,0,0,0,0,0,0,0,0,0
150,V.K克,0,2,2,0,0.001864512,0.099985425,0,0,0,2,2
151,林宥嘉,0,0,0,0,0,0,0,0,0,0,0
152,莫西子诗,6,0,6,0.004883246,0,0.148512775,0,0,7,0,7
153,鲁向卉,2,1,3,0.001864512,0.001243008,0.148546528,2,7.74E-07,2,1,3
154,eddy盖奶,3,0,3,0.002486016,0,0.133907954,0,0,3,0,3
155,董雪婷,0,1,1,0,0.001243008,0.139420803,0,0,0,1,1
156,Ookay,12,0,12,0.015774721,0,0.183031286,0,0,13,0,13
157,Fleurie,0,0,0,0,0,0,0,0,0,0,0
158,PEATLE,0,1,1,0,0.001243008,0.128763736,0,0,0,1,1
159,大坏兔子,0,4,4,0,0.00310752,0.157457173,0,0,0,4,4
160,阿杜,2,0,2,0.001864512,0,0.13543405,0,0,2,0,2
161,潘小芬,0,3,3,0,0.002663589,0.140138234,0,0,0,3,3
162,炸炸,0,0,0,0,0,0,0,0,0,0,0
163,邱有句,5,0,5,0.003729024,0,0.156140641,0,0,5,0,5
164,Tujamo,0,0,0,0,0,0,0,0,0,0,0
165,小艾EYE,1,0,1,0.001243008,0,0.134597348,0,0,1,0,1
166,DU丢丢丢,2,0,2,0.001864512,0,0.125572473,0,0,2,0,2
167,EXIA,0,6,6,0,0.004350528,0.151895125,0,0,0,6,6
168,Tritonal,0,0,0,0,0,0,0,0,0,0,0
169,张碧晨,2,0,2,0.001864512,0,0.154699343,0,0,2,0,2
170,杨多,0,1,1,0,0.001243008,0.151648428,0,0,0,1,1
171,RobertFalcon,0,0,0,0,0,0,0,0,0,0,0
172,ProgressiveDigitalStation,0,1,1,0,0.001243008,0.134182863,0,0,0,1,1
173,雷雨心,0,1,1,0,0.001243008,0.001243008,0,0,0,1,1
174,莫安琪AngelMo,0,0,0,0,0,0,0,0,0,0,0
175,DillonFrancis,0,0,0,0,0,0,0,0,0,0,0
176,魏小也,0,0,0,0,0,0,0,0,0,0,0
177,聚来提,0,0,0,0,0,0,59,0,0,0,0
178,GC国丞,4,2,6,0.00832275,0.001775726,0.117470295,0,2.28E-05,4,3,7
179,UZ,0,3,3,0,0.006007872,0.155991581,0,0,0,3,3
180,Ofenbach,0,0,0,0,0,0,0,0,0,0,0
181,九宝乐队,4,0,4,0.005327177,0,0.159844638,0,0,4,0,4
182,谢天笑,8,0,8,0.006525792,0,0.169152361,0,0,8,0,8
183,oNEwAY,0,1,1,0,0.001243008,0.133716187,0,0,0,1,1
184,废墟乐队,0,0,0,0,0,0,0,0,0,0,0
185,月代彩,6,0,6,0.004350528,0,0.179364633,0,0,6,0,6
186,灰色,0,1,1,0,0.001243008,0.001243008,0,0,0,1,1
187,任升,0,5,5,0,0.003867136,0.151718831,0,0,0,5,5
188,芮甜甜,0,0,0,0,0,0,0,0,0,0,0
189,MLK麋鹿王国,1,0,1,0.001243008,0,0.126276028,0,0,1,0,1
190,澄海伯伯,0,6,6,0,0.005623132,0.15140253,0,0,0,6,6
191,Deca,0,0,0,0,0,0,0,0,0,0,0
192,紫堂宿,0,3,3,0,0.002938019,0.140138234,0,0,0,4,4
193,mAjorHon,19,0,19,0.020891071,0,0.189012355,12,0,20,0,20
194,JAEFOREAL,1,4,5,0.001243008,0.003343263,0.141564809,0,4.64E-06,1,4,5
195,PaRaDSE,0,1,1,0,0.001243008,0.001243008,6,0,0,1,1
196,魏雪漫,2,1,3,0.002175264,0.001243008,0.147607209,0,2.32E-06,2,1,3
197,AlanWalker,0,0,0,0,0,0,0,0,0,0,0
198,阿力木江·托合提,0,7,7,0,0.005085033,0.162709665,0,0,0,7,7
199,ShahMat,0,2,2,0,0.00207168,0.137862207,0,0,0,2,2
200,马潇,0,0,0,0,0,0,0,0,0,0,0
201,郭思达,0,0,0,0,0,0,0,0,0,0,0
202,新乐尘符,1,1,2,0.001243008,0.001243008,0.083913817,0,0,1,1,2
203,阿森,0,1,1,0,0.001243008,0.144859203,0,0,0,1,1
204,熊熊作业,1,0,1,0.001243008,0,0.123158983,0,0,1,0,1
205,网易CC直播,1,0,1,0.001243008,0,0.161903573,0,0,1,0,1
206,钟立风,2,0,2,0.003080498,0,0.139748711,0,0,2,0,2
207,ABSDJHONG,0,3,3,0,0.002486016,0.139124036,0,0,0,3,3
208,Worezh,2,0,2,0.001864512,0,0.124259453,0,0,2,0,2
209,Controls,0,11,11,0,0.007458048,0.153934226,0,0,0,11,11
210,KBShinya,3,0,3,0.004031378,0,0.153392331,322.5,0,6,0,6
211,丽江小倩,1,14,15,0.002677248,0.013594168,0.175088327,0,1.25E-04,1,14,15
212,BingoPlayers,0,0,0,0,0,0,0,0,0,0,0
213,TalkboxRocKit,0,2,2,0,0.002532053,0.134708311,0,0,0,2,2
214,王珮瑜,1,0,1,0.001243008,0,0.001243008,0,0,1,0,1
215,薄云天,0,0,0,0,0,0,2,0,0,0,0
216,Nona_Q,2,1,3,0.001864512,0.001243008,0.102046015,0,7.74E-07,2,1,3
217,段丽阳,0,0,0,0,0,0,0,0,0,0,0
218,杨烁,0,0,0,0,0,0,0,0,0,0,0
219,李常超(Lao乾妈),0,1,1,0,0.001243008,0.136794626,0,0,0,1,1
220,黄榕生,0,2,2,0,0.005053098,0.130930433,0,0,0,5,5
221,北树乐队,1,0,1,0.001243008,0,0.126154164,0,0,1,0,1
222,郑建鹏,0,1,1,0,0.001243008,0.141136844,0,0,0,1,1
223,英雄联盟,1,0,1,0.001243008,0,0.001243008,0,0,1,0,1
224,雲道娱乐,3,0,3,0.00483392,0,0.160986385,0,0,4,0,4
225,RANA.Queen,0,1,1,0,0.001243008,0.125020031,0,0,0,1,1
226,梦灵,0,1,1,0,0.001243008,0.001243008,0,0,0,1,1
227,逃跑计划,0,0,0,0,0,0,0,0,0,0,0
228,昼夜,0,1,1,0,0.001243008,0.152961555,0,0,0,1,1
229,Habstrakt,0,0,0,0,0,0,0,0,0,0,0
230,胡灵,0,0,0,0,0,0,18.5,0,0,0,0
231,金玟岐,12,2,14,0.008079553,0.001864512,0.18879397,0,7.16E-06,12,2,14
232,蒋大为,0,0,0,0,0,0,8,0,0,0,0
233,冰块先生,4,1,5,0.003442176,0.001243008,0.156252623,84,3.10E-06,4,1,5
234,Yoken_Official,3,7,10,0.002486016,0.008701057,0.172728521,0,3.25E-05,3,7,10
235,脑浊乐队,2,0,2,0.001864512,0,0.134652807,0,0,2,0,2
236,半梦,0,6,6,0,0.00920197,0.163687634,0,0,0,6,6
237,麦组合,0,1,1,0,0.001243008,0.001243008,3,0,0,1,1
238,Rita黄汐源,1,2,3,0.001243008,0.001864512,0.158488051,0,1.16E-06,1,2,3
239,张信哲,0,0,0,0,0,0,0,0,0,0,0
240,张杰,5,0,5,0.003729024,0,0.138299772,0,0,10,0,10
241,复乐班,0,6,6,0,0.007299367,0.179957248,0,0,0,6,6
242,王齐铭WatchMe,9,0,9,0.00621504,0,0.162064152,0,0,9,0,9
243,Shaggy,0,0,0,0,0,0,0,0,0,0,0
244,Calculasian,0,1,1,0,0.001243008,0.145991674,0,0,0,1,1
245,王广允,0,0,0,0,0,0,0,0,0,0,0
246,AkaneXIii茜,1,0,1,0.001243008,0,0.161903573,0,0,1,0,1
247,CasinoDemon,0,0,0,0,0,0,0,0,0,0,0
248,秦岚,0,1,1,0,0.001243008,0.001243008,0,0,0,1,1
249,VOGUE,0,0,0,0,0,0,0,0,0,0,0
250,猫女林,0,0,0,0,0,0,0,0,0,0,0
251,箱子君,0,2,2,0,0.003589186,0.121015501,0,0,0,2,2
252,高铭,0,1,1,0,0.001243008,0.001243008,9,0,0,1,1
253,林斜阳,1,3,4,0.001243008,0.002663589,0.141995378,0,3.48E-06,2,3,5
254,马帮乐队,1,0,1,0.001243008,0,0.130642559,24,0,1,0,1
255,KingStar,4,3,7,0.003262896,0.002900352,0.121082757,0,9.29E-06,4,3,7
256,高晨薇,0,2,2,0,0.001864512,0.121352529,0,0,0,4,4
257,土不叔叔乐队,1,0,1,0.001243008,0,0.109371607,0,0,1,0,1
258,FarEastMovement,0,2,2,0,0.001864512,0.113709938,1,0,0,7,7
259,陶峻汐,1,1,2,0.001243008,0.001243008,0.134155321,0,3.87E-07,1,1,2
260,秋火林荫,0,9,9,0,0.00621504,0.156066075,0,0,0,9,9
261,靳松,0,0,0,0,0,0,0,0,0,0,0
262,潘虹樾,0,0,0,0,0,0,0,0,0,0,0
263,ZER,0,6,6,0,0.004825796,0.153140751,2,0,0,6,6
264,苟瀚中,1,2,3,0.001243008,0.001864512,0.150184909,0,7.74E-07,1,2,3
265,庆庆,0,5,5,0,0.007263828,0.160946743,0,0,0,5,5
266,泥鳅Niko,3,0,3,0.00349596,0,0.131140595,24,0,3,0,3
267,吕大叶,1,4,5,0.002796768,0.00233064,0.12858641,0,9.29E-06,1,4,5
268,宮脇詩音,0,0,0,0,0,0,0,0,0,0,0
269,Polymath,2,0,2,0.001864512,0,0.15543513,0,0,2,0,2
270,范炜与程渤智,0,1,1,0,0.001243008,0.087980175,0,0,0,1,1
271,ALow.,0,2,2,0,0.001864512,0.151895125,0,0,0,3,3
272,蔡淳佳,1,0,1,0.001243008,0,0.139183289,0,0,1,0,1
273,邵言,1,0,1,0.001243008,0,0.122581531,0,0,1,0,1
274,LOKEY低调组合,0,1,1,0,0.001243008,0.123414789,0,0,0,1,1
275,JesseCook,0,0,0,0,0,0,0,0,0,0,0
276,Tonino祖力,3,0,3,0.002486016,0,0.132068039,0,0,3,0,3
277,Katana_real,0,1,1,0,0.001243008,0.133552252,0,0,0,1,1
278,NeverBefore,0,0,0,0,0,0,59.667,0,0,0,0
279,LuckyMaxx,8,1,9,0.022753368,0.001243008,0.182980046,0,2.31E-05,8,1,9
280,奉枫,0,0,0,0,0,0,0,0,0,0,0
281,彭远扬,0,0,0,0,0,0,0,0,0,0,0
282,uncle,0,1,1,0,0.004624721,0.148411608,0,0,0,1,1
283,Mu,0,7,7,0,0.007631491,0.16258824,0,0,0,7,7
284,OmenXIII,5,0,5,0.003995383,0,0.168890109,0,0,5,0,5
285,Candy_Wind,0,7,7,0,0.006434395,0.153934226,0,0,0,7,7
286,Cilantro_killer,0,2,2,0,0.001864512,0.13434835,0,0,0,2,2
287,Nootag,1,0,1,0.001243008,0,0.084357863,0,0,1,0,1
288,何曼婷,0,0,0,0,0,0,0,0,0,0,0
289,唐音工作室,0,3,3,0,0.002486016,0.157229907,0,0,0,3,3
290,可乐就是力量,0,2,2,0,0.003598181,0.154115709,0,0,0,2,2
291,UmmetOzcan,0,0,0,0,0,0,0,0,0,0,0
292,Blaster,0,0,0,0,0,0,0,0,0,0,0
293,炁体源流,0,1,1,0,0.00581634,0.143902405,0,0,0,1,1
294,KOH,0,2,2,0,0.001864512,0.144666827,0,0,0,2,2
295,持枪萝莉,0,1,1,0,0.00149161,0.096544272,0,0,0,1,1
296,姚雪,0,0,0,0,0,0,0,0,0,0,0
297,芳蓉,0,0,0,0,0,0,0,0,0,0,0
298,范忆堂,0,1,1,0,0.00669312,0.125211633,0,0,0,1,1
299,eigenTunes亦听,0,1,1,0,0.001243008,0.105148765,0,0,0,1,1
300,四季音色,6,0,6,0.004350528,0,0.144060993,0,0,6,0,6
301,邱胜翊,0,0,0,0,0,0,0,0,0,0,0
302,安悦溪,0,0,0,0,0,0,0,0,0,0,0
303,贰鱼,1,0,1,0.001243008,0,0.001243008,0,0,1,0,1
304,葛八岁,1,0,1,0.001243008,0,0.125548353,0,0,1,0,1
305,豆心,0,1,1,0,0.00310752,0.146154902,0,0,0,3,3
306,依兴驰,5,0,5,0.003729024,0,0.166396315,0,0,6,0,6
307,彭家熙,0,3,3,0,0.002486016,0.141289391,0,0,0,3,3
308,SimorE,0,1,1,0,0.001243008,0.132148145,0,0,0,1,1
309,余佳运,22,0,22,0.021823835,0,0.184738475,0,0,23,0,23
310,何艺纱,0,0,0,0,0,0,0,0,0,0,0
311,拜合提亚bahtiyaraziz,0,9,9,0,0.007313932,0.171280064,0,0,0,9,9
312,BNC$BrandNewCohort,0,1,1,0,0.001243008,0.114687616,0,0,0,1,1
313,NIKI,0,0,0,0,0,0,0,0,0,0,0
314,高赫,0,0,0,0,0,0,0,0,0,0,0
315,千坂,15,0,15,0.020538479,0,0.184425712,0,0,15,0,15
316,Kael鹿帆,0,2,2,0,0.001864512,0.138563647,0,0,0,2,2
317,青春美少女,0,0,0,0,0,0,0,0,0,0,0
318,EasyRider逍遥骑士,0,0,0,0,0,0,0,0,0,0,0
319,黑戒,0,0,0,0,0,0,1.5,0,0,0,0
320,谷柏杉,1,2,3,0.001243008,0.001864512,0.157533074,0,5.80E-07,1,2,3
321,阿基耐,0,0,0,0,0,0,0,0,0,0,0
322,唐朝乐队,0,0,0,0,0,0,0,0,0,0,0
323,nin,0,8,8,0,0.005593536,0.16275018,0,0,0,8,8
324,曲言,0,1,1,0,0.001243008,0.001243008,0,0,0,3,3
325,Ezzek,1,0,1,0.001243008,0,0.11778784,0,0,1,0,1
326,Datsik,0,0,0,0,0,0,0,0,0,0,0
327,王杰,3,0,3,0.003729024,0,0.13809523,0,0,3,0,3
328,Lonely,0,2,2,0,0.002610317,0.12157826,0,0,0,2,2
329,王大毛,0,0,0,0,0,0,0,0,0,0,0
330,崔跃文,2,0,2,0.001864512,0,0.14131994,0,0,2,0,2
331,YUJay,0,1,1,0,0.001243008,0.139629294,0,0,0,1,1
332,汪峰,6,0,6,0.004350528,0,0.148142503,0,0,6,0,6
333,王欣宇,0,1,1,0,0.005016745,0.130904211,0,0,0,2,2
334,Cesqeaux,10,0,10,0.008972965,0,0.160669794,7,0,10,0,10
335,雪无影,3,1,4,0.005932539,0.001243008,0.128561118,0,2.71E-06,3,9,12
336,艾怡良,0,0,0,0,0,0,0,0,0,0,0
337,杨晓川,0,1,1,0,0.00310752,0.146154902,0,0,0,1,1
338,王华峰,2,0,2,0.001864512,0,0.12367166,0,0,2,0,2
339,TylerWard,0,0,0,0,0,0,4,0,0,0,0
340,Nyaameow,1,5,6,0.001243008,0.003867136,0.154406975,64,1.55E-06,1,6,7
341,Arcticloudz,2,3,5,0.012215769,0.005463454,0.149327102,0,2.48E-05,2,3,5
342,Biscuits,0,2,2,0,0.003598181,0.12632484,0,0,0,3,3
343,贾昱,0,0,0,0,0,0,0,0,0,0,0
344,茶凉粉乐队,0,0,0,0,0,0,32,0,0,0,0
345,李惠芹,1,5,6,0.001243008,0.00492024,0.162386267,0,1.24E-05,1,5,6
346,ChineseFootball,0,1,1,0,0.001243008,0.13685191,0,0,0,1,1
347,TYRX,3,0,3,0.014586057,0,0.14861408,0,0,3,0,3
348,Wya乌鸦,1,0,1,0.001243008,0,0.001243008,0,0,1,0,1
349,任意门,0,2,2,0,0.001864512,0.145763765,0,0,0,2,2
350,赵紫骅,0,0,0,0,0,0,0,0,0,0,0
351,林允,0,0,0,0,0,0,0,0,0,0,0
352,张震岳,0,0,0,0,0,0,0,0,0,0,0
353,鸾凤鸣原创音乐团队,0,2,2,0,0.001864512,0.14286442,0,0,0,2,2
354,李子阳,0,4,4,0,0.007802095,0.163851773,0,0,0,4,4
355,三藏梵音,0,0,0,0,0,0,0,0,0,0,0
356,涵昱,0,1,1,0,0.001243008,0.001243008,0,0,0,1,1
357,潇梦临,0,1,1,0,0.001243008,0.110780462,148,0,0,1,1
358,Marycobi,4,3,7,0.012300601,0.006909663,0.164553052,0,5.73E-05,4,3,7
359,热斑乐队,1,0,1,0.001243008,0,0.134597348,0,0,1,0,1
360,朱哲琴,4,0,4,0.003418272,0,0.153320367,0,0,4,0,4
361,re:plus,0,0,0,0,0,0,103,0,0,0,0
362,毛不易,12,1,13,0.0193126,0.001243008,0.176459159,0,3.99E-05,12,2,14
363,丁世光,0,2,2,0,0.001864512,0.145666308,1,0,0,2,2
364,王一鸣Iris,1,2,3,0.001243008,0.001864512,0.156927905,0,3.87E-07,1,2,3
365,暴走蜗牛乐队,0,3,3,0,0.00741024,0.163564746,0,0,0,3,3
366,Diskord,3,0,3,0.01638307,0,0.173048643,0,0,3,0,3
367,丹Sir,0,0,0,0,0,0,0,0,0,0,0
368,杨嘉松,0,0,0,0,0,0,0,0,0,0,0
369,小红帽,0,0,0,0,0,0,1,0,0,0,0
370,Ramila_Rozimamat,1,1,2,0.001243008,0.001243008,0.001864512,0,3.87E-07,1,1,2
371,莫君倾,0,0,0,0,0,0,0,0,0,0,0
372,kidult.,0,1,1,0,0.001243008,0.122858031,0,0,0,1,1
373,ElleQu,0,1,1,0,0.001243008,0.13876958,0,0,0,1,1
374,陆陆桑,2,0,2,0.001864512,0,0.125572473,0,0,2,0,2
375,Alesso,19,0,19,0.013517713,0,0.185367193,0,0,19,0,19
376,DJcc,0,1,1,0,0.001243008,0.133035767,0,0,0,1,1
377,科尔薇,0,4,4,0,0.008416201,0.165051698,0,0,0,4,4
378,情词尧,0,0,0,0,0,0,0,0,0,0,0
379,高丽馥,0,0,0,0,0,0,0,0,0,0,0
380,秦勇,0,0,0,0,0,0,0,0,0,0,0
381,ToddLi,0,1,1,0,0.001243008,0.128687679,0,0,0,2,2
382,李沫萱,0,4,4,0,0.00310752,0.161344044,0,0,0,4,4
383,小爱的妈,0,2,2,0,0.001864512,0.149737623,0,0,0,2,2
384,雏葵,5,0,5,0.003729024,0,0.140772071,0,0,5,0,5
385,PNC说唱,2,0,2,0.003196306,0,0.142989439,0,0,2,0,2
386,祁紫檀,0,2,2,0,0.005941852,0.155620172,0,0,0,2,2
387,OVDS,0,0,0,0,0,0,20,0,0,0,0
388,陈致逸,4,1,5,0.005317312,0.001243008,0.151930433,0,7.74E-06,4,1,5
389,RED,0,2,2,0,0.004189398,0.144474961,0,0,0,2,2
390,Yultron,0,0,0,0,0,0,0,0,0,0,0
391,Smooka,0,0,0,0,0,0,0,0,0,0,0
392,TheGlitchMob,0,1,1,0,0.001243008,0.001243008,0,0,0,1,1
393,Rise,0,0,0,0,0,0,349,0,0,0,0
394,买辣椒也用券,7,9,16,0.00621504,0.00770665,0.185788722,0,1.35E-04,7,9,16
395,泰然,0,10,10,0,0.008826613,0.17636393,0,0,0,10,10
396,京脸儿,0,1,1,0,0.001243008,0.087944661,0,0,0,1,1
397,坚持者,0,1,1,0,0.001243008,0.134100272,0,0,0,1,1
398,不靠谱组合,1,0,1,0.001243008,0,0.11570273,0,0,1,0,1
399,重塑雕像的权利,1,0,1,0.001243008,0,0.001243008,0,0,1,0,1
400,吴克群,2,0,2,0.001864512,0,0.126178518,0,0,2,0,2
401,于子将,0,1,1,0,0.001243008,0.132335437,0,0,0,1,1
402,踏云社,1,0,1,0.001243008,0,0.153897981,0,0,1,0,1
403,麻吉弟弟,0,0,0,0,0,0,0,0,0,0,0
404,张三弥,1,0,1,0.001243008,0,0.135293878,0,0,1,0,1
405,阿力普,0,8,8,0,0.00569712,0.161264427,0,0,0,8,8
406,芙蓉帐暖夜笙歌,1,0,1,0.001243008,0,0.001243008,0,0,1,0,1
407,乔嘉,0,0,0,0,0,0,0,0,0,0,0
408,好妹妹,0,1,1,0,0.001243008,0.154297621,0,0,0,1,1
409,DJ宋雨飞已退,0,1,1,0,0.001243008,0.001243008,0,0,0,1,1
410,百慕三石,0,6,6,0,0.003729024,0.15711652,0,0,0,6,6
411,薛明媛,0,6,6,0,0.009638764,0.159766493,0,0,0,6,6
412,薄彩生,2,0,2,0.001864512,0,0.153970488,11,0,2,0,2
413,音阙诗听,8,1,9,0.006525792,0.001243008,0.15655203,0,4.26E-06,19,1,20
414,冯言,0,0,0,0,0,0,0,0,0,0,0
415,Bikman,0,3,3,0,0.005932539,0.165385811,0,0,0,3,3
416,FromTheRed,0,0,0,0,0,0,0,0,0,0,0
417,ICE,0,1,1,0,0.001243008,0.001243008,0,0,0,1,1
418,CyanLpegd,0,61,61,0,0.045256303,0.216928219,0,0,0,61,61
419,温莎森林,1,0,1,0.001243008,0,0.001243008,0,0,1,0,1
420,索朗扎西,0,0,0,0,0,0,75.5,0,0,0,0
421,徐大乐,4,1,5,0.018168786,0.001243008,0.160393797,0,2.92E-05,4,1,5
422,廖俊涛,4,0,4,0.015412233,0,0.163278722,0,0,5,0,5
423,promema,0,1,1,0,0.001243008,0.154297621,0,0,0,1,1
424,曾之乔,1,0,1,0.001243008,0,0.086444217,0,0,1,0,1
425,Lu,0,1,1,0,0.001243008,0.125862647,0,0,0,1,1
426,精气神制作,0,1,1,0,0.001243008,0.116819432,0,0,0,1,1
427,汪定中,0,0,0,0,0,0,0,0,0,0,0
428,AvTProject,0,2,2,0,0.001864512,0.149122684,0,0,0,2,2
429,AnimaOMG,2,0,2,0.016516607,0,0.150426864,0,0,2,0,2
430,彭坦,3,0,3,0.003729024,0,0.16258824,0,0,3,0,3
431,王筝,1,0,1,0.001243008,0,0.1427708,0,0,1,0,1
432,HIROOMITOSAKA,0,0,0,0,0,0,0,0,0,0,0
433,发条卡目索,0,0,0,0,0,0,0,0,0,0,0
434,飘乐队,0,1,1,0,0.001243008,0.131961382,0,0,0,1,1
435,earlybus,1,0,1,0.001243008,0,0.134597348,0,0,1,0,1
436,LogicLoc,0,12,12,0,0.013755174,0.17038705,0,0,0,12,12
437,歌浴森,1,0,1,0.001243008,0,0.136338073,0,0,1,0,1
438,包晗言,0,0,0,0,0,0,0,0,0,0,0
439,暖场小粽子,0,4,4,0,0.00310752,0.156702163,0,0,0,4,4
440,浜崎あゆみ,0,0,0,0,0,0,0,0,0,0,0
441,叶蓓,4,0,4,0.002938019,0,0.14453886,0,0,4,0,4
442,TedJon,1,0,1,0.001243008,0,0.109408223,0,0,1,0,1
443,野外合作社,2,0,2,0.016136505,0,0.157837412,0,0,2,0,2
444,Zeraphym,7,0,7,0.004972032,0,0.172957058,0,0,7,0,7
445,斑辣个马,0,15,15,0,0.016303641,0.183442246,0,0,0,15,15
446,Fine乐团,11,0,11,0.009821515,0,0.165931638,0,0,11,0,11
447,Sula,0,6,6,0,0.010990808,0.169327649,0,0,0,6,6
448,OgreYouAsshole,0,0,0,0,0,0,0,0,0,0,0
449,单丹,0,0,0,0,0,0,0,0,0,0,0
450,Octave,0,0,0,0,0,0,0,0,0,0,0
451,李官卫,1,0,1,0.001243008,0,0.001243008,0,0,1,0,1
452,渔圈,0,0,0,0,0,0,193.883,0,0,0,0
453,EDMarco,9,19,28,0.006310656,0.011851938,0.188903099,0,7.50E-05,9,19,28
454,叶洛洛,0,5,5,0,0.005615733,0.142087983,0,0,0,5,5
455,宫俊,0,1,1,0,0.001243008,0.148512775,0,0,0,1,1
456,单海锋,0,1,1,0,0.001243008,0.103598783,13,0,0,1,1
457,MC-,3,2,5,0.004616887,0.001864512,0.12210064,0,5.03E-06,3,2,5
458,卢小旭,0,0,0,0,0,0,0,0,0,0,0
459,Sub,0,1,1,0,0.00367498,0.134902936,0,0,0,1,1
460,南偿,0,1,1,0,0.001243008,0.118471039,0,0,0,1,1
461,莫籽,0,0,0,0,0,0,32,0,0,0,0
462,流浪的蛙蛙,4,2,6,0.005282784,0.001864512,0.144188115,0,1.24E-05,4,2,6
463,Sikdope,0,0,0,0,0,0,8,0,0,0,0
464,龚子婕JessieG,1,1,2,0.002796768,0.001243008,0.143146019,0,3.10E-06,1,1,2
465,彭琦,0,0,0,0,0,0,0,0,0,0,0
466,李健,13,0,13,0.012161704,0,0.190610885,0,0,13,0,13
467,周子琰,10,0,10,0.00641798,0,0.170076691,0,0,10,0,10
468,AniFace,0,6,6,0,0.00466128,0.149088669,0,0,0,6,6
469,宋马超,0,0,0,0,0,0,0,0,0,0,0
470,Odoriin,0,1,1,0,0.001243008,0.123624877,0,0,0,1,1
471,雷智皓,0,3,3,0,0.005327177,0.152604418,0,0,0,3,3
472,徐靖博,0,0,0,0,0,0,0,0,0,0,0
473,MuratjanMuxter,2,0,2,0.001864512,0,0.133008694,0,0,2,0,2
474,李玉刚,3,0,3,0.002486016,0,0.148986716,0,0,3,0,3
475,冲击力乐队,0,0,0,0,0,0,0,0,0,0,0
476,杨琨,0,1,1,0,0.001243008,0.119927472,0,0,0,1,1
477,蒋亮的声音系统,1,0,1,0.001243008,0,0.134486569,0,0,1,0,1
478,王珞丹,3,0,3,0.003633408,0,0.140168287,0,0,3,0,3
479,梁栋江,3,0,3,0.003038464,0,0.142958163,0,0,3,0,3
480,JV陈政文,0,0,0,0,0,0,0,0,0,0,0
481,TheWillOnKill,0,1,1,0,0.001243008,0.001243008,0,0,0,1,1
482,帝玖管弦乐团,0,0,0,0,0,0,0,0,0,0,0
483,JasonCasper,0,1,1,0,0.001243008,0.133035767,0,0,0,1,1
484,那吾克热LIL-EM,8,0,8,0.005593536,0,0.172091818,0,0,8,0,8
485,啊晗Britany,0,5,5,0,0.005141533,0.167547994,0,0,0,5,5
486,马条,4,0,4,0.017340437,0,0.155694312,0,0,4,0,4
487,Vacance.ZEN,0,0,0,0,0,0,0,0,0,0,0
488,Headhunterz,17,0,17,0.011881695,0,0.179957248,0,0,17,0,17
489,阿杰,1,0,1,0.001243008,0,0.11490941,0,0,1,0,1
490,Quintino,0,0,0,0,0,0,0,0,0,0,0
491,冯提莫,11,0,11,0.007540916,0,0.186584277,0,0,11,0,11
492,TheCandleThieves,0,0,0,0,0,0,0,0,0,0,0
493,BHTY-R,0,2,2,0,0.001864512,0.140108194,0,0,0,2,2
494,任和,0,6,6,0,0.004350528,0.167119592,0,0,0,6,6
495,张宇桦,0,0,0,0,0,0,0,0,0,0,0
496,洛天依,9,0,9,0.00621504,0,0.176888964,0,0,9,0,9
497,FADERONE,0,1,1,0,0.001243008,0.138124413,0,0,0,1,1
498,胡拾梅,0,1,1,0,0.001243008,0.148512775,0,0,0,1,1
499,牛奶咖啡,0,1,1,0,0.001243008,0.111327665,0,0,0,1,1
500,NOTD,0,0,0,0,0,0,0,0,0,0,0
501,异种,0,0,0,0,0,0,0,0,0,0,0
502,千鸟鸟,0,11,11,0,0.007458048,0.156289986,0,0,0,11,11
503,叶菁菁,0,1,1,0,0.001243008,0.143271531,0,0,0,1,1
504,浅堤,0,0,0,0,0,0,0,0,0,0,0
505,乐正绫,2,0,2,0.001864512,0,0.158911919,0,0,2,0,2
506,OllyMurs,4,0,4,0.00310752,0,0.142087983,0,0,4,0,4
507,BEJ,0,0,0,0,0,0,0,0,0,0,0
508,匡桐菲,0,0,0,0,0,0,629.5,0,0,0,0
509,方大同,15,4,19,0.012630566,0.006242062,0.193374179,0,2.44E-04,15,4,19
510,刘忻,0,0,0,0,0,0,0,0,0,0,0
511,王闻,0,0,0,0,0,0,0,0,0,0,0
512,DJZacco,0,1,1,0,0.005607348,0.154188423,0,0,0,1,1
513,苏诗丁,1,0,1,0.001243008,0,0.122581531,0,0,1,0,1
514,欧阳耀莹,0,0,0,0,0,0,0,0,0,0,0
515,青子,0,1,1,0,0.00566618,0.137254247,0,0,0,1,1
516,GZ,0,6,6,0,0.013376592,0.177224708,0,0,0,7,7
517,动力火车,0,0,0,0,0,0,0,0,0,0,0
518,音频怪物,9,0,9,0.00621504,0,0.174108877,0,0,9,0,9
519,平井大,0,0,0,0,0,0,0,0,0,0,0
520,AmaO,0,24,24,0,0.021729408,0.177996929,0,0,0,24,24
521,浪荡绅士,0,1,1,0,0.00155376,0.112052927,0,0,0,1,1
522,安浩,0,8,8,0,0.004972032,0.165553375,0,0,0,8,8
523,毕书尽,0,0,0,0,0,0,0,0,0,0,0
524,BloodyWoods,0,1,1,0,0.007801511,0.119379858,0,0,0,2,2
525,DJ-Varc,0,2,2,0,0.001864512,0.14661389,0,0,0,2,2
526,SeeB,0,0,0,0,0,0,0,0,0,0,0
527,风见学园蔚蓝组,0,1,1,0,0.001243008,0.136252809,0,0,0,1,1
528,于湉,0,0,0,0,0,0,0,0,0,0,0
529,苗田雨,0,1,1,0,0.001243008,0.145633851,0,0,0,1,1
530,OnlyReal,0,0,0,0,0,0,0,0,0,0,0
531,范世坤吉他私塾,0,0,0,0,0,0,0,0,0,0,0
532,DJSoviet,0,45,45,0,0.032534062,0.202793895,0,0,0,45,45
533,新香水,0,0,0,0,0,0,0,0,0,0,0
534,poree,0,3,3,0,0.002486016,0.097204748,0,0,0,3,3
535,OceansWhoLied,1,0,1,0.002007936,0,0.145342389,0,0,1,0,1
536,花玲,0,2,2,0,0.003878185,0.142242595,0,0,0,2,2
537,TFBOYS,0,0,0,0,0,0,0,0,0,0,0
538,萧忆情Alex,4,0,4,0.005904288,0,0.138124413,0,0,4,0,4
539,洪辰,0,1,1,0,0.001243008,0.148512775,0,0,0,1,1
540,何山,0,4,4,0,0.00310752,0.150184909,0,0,0,4,4
541,赵鹏,0,2,2,0,0.001864512,0.131722032,0,0,0,2,2
542,库亦晨,0,4,4,0,0.00310752,0.149327102,0,0,0,4,4
543,SAR_H,0,0,0,0,0,0,0,0,0,0,0
544,丁薇,0,0,0,0,0,0,0,0,0,0,0
545,崔子格,4,0,4,0.00310752,0,0.131510005,0,0,4,0,4
546,GumJ,0,1,1,0,0.00213642,0.121895696,0,0,0,1,1
547,ChinaJTA,0,2,2,0,0.001864512,0.141595477,0,0,0,2,2
548,方磊,0,1,1,0,0.001243008,0.109043164,1,0,0,1,1
549,蒋瑶佳,1,1,2,0.001243008,0.001243008,0.158219492,64,3.87E-07,1,1,2
550,麦子杰,5,3,8,0.007253318,0.002486016,0.154079378,0,2.48E-05,5,3,8
551,大主宰乐团TheMaster,0,0,0,0,0,0,0,0,0,0,0
552,周汤豪,0,0,0,0,0,0,0,0,0,0,0
553,高姗,4,0,4,0.004866693,0,0.135070205,0,0,4,0,4
554,旅行团,2,0,2,0.001864512,0,0.13688057,0,0,2,0,2
555,北冈健太,0,0,0,0,0,0,0,0,0,0,0
556,庄心妍,1,0,1,0.001243008,0,0.118149805,0,0,1,0,1
557,顽童MJ,0,0,0,0,0,0,0,0,0,0,0
558,谣君,3,0,3,0.002663589,0,0.096601348,0,0,3,0,3
559,SeanKingston,0,0,0,0,0,0,0,0,0,0,0
560,徐誉滕,0,0,0,0,0,0,0,0,0,0,0
561,Kaskade,0,0,0,0,0,0,0,0,0,0,0
562,G.E.M.邓紫棋,0,1,1,0,0.001243008,0.109591671,2,0,0,1,1
563,兰芽yaya,1,2,3,0.001243008,0.001864512,0.139539864,0,7.74E-07,1,2,3
564,寂悸,0,4,4,0,0.00310752,0.151683621,0,0,0,4,4
565,新疆SPEAKER说唱,1,0,1,0.002237415,0,0.107025499,0,0,1,0,1
566,霹雳布袋戏,0,0,0,0,0,0,0,0,0,0,0
567,黑羊,0,2,2,0,0.00207168,0.140409178,19,0,0,2,2
568,曹槽,4,3,7,0.003995383,0.002486016,0.163442041,11,7.35E-06,4,3,7
569,HAO付豪,4,1,5,0.00310752,0.001775726,0.135912814,0,4.26E-06,4,1,5
570,Honne,0,0,0,0,0,0,0,0,0,0,0
571,Nop,0,0,0,0,0,0,0,0,0,0,0
572,韩旭,0,7,7,0,0.006511878,0.172819863,114,0,0,7,7
573,J-Sleeper性感的拖鞋,7,5,12,0.008903997,0.003255497,0.172546126,0,4.41E-05,7,5,12
574,陈粒,21,0,21,0.016752781,0,0.203488395,0,0,21,0,21
575,Ray,0,3,3,0,0.006282595,0.156364766,0,0,0,3,3
576,Muo,0,3,3,0,0.00379808,0.156965592,0,0,0,3,3
577,MINSTA,1,0,1,0.001243008,0,0.107518461,0,0,1,0,1
578,王冰洋,0,0,0,0,0,0,0,0,0,0,0
579,CrazyUp!,0,3,3,0,0.002486016,0.144443033,0,0,0,3,3
580,陈斐,0,1,1,0,0.007801511,0.119379858,0,0,0,1,1
581,DavidGuetta,0,0,0,0,0,0,0,0,0,0,0
582,powerA,0,0,0,0,0,0,5,0,0,0,0
583,可歆,3,2,5,0.002373015,0.002175264,0.110593016,0,1.93E-06,3,2,5
584,白宁,0,1,1,0,0.001243008,0.127234714,10,0,0,1,1
585,青春老少年,1,2,3,0.001243008,0.003598181,0.148142503,0,3.87E-06,1,2,3
586,曹秦,3,0,3,0.003729024,0,0.149497878,0,0,3,0,3
587,Korpiklaani,0,0,0,0,0,0,0,0,0,0,0
588,邱比,2,0,2,0.00332636,0,0.145310076,0,0,2,0,2
589,朱星杰,0,1,1,0,0.001243008,0.128561118,0,0,0,1,1
590,念蓁,0,1,1,0,0.00149161,0.114506784,0,0,0,1,1
591,Six,0,0,0,0,0,0,0,0,0,0,0
592,BettyWho,0,0,0,0,0,0,0,0,0,0,0
593,Makino,0,2,2,0,0.001864512,0.14674556,0,0,0,2,2
594,大哲,0,0,0,0,0,0,0,0,0,0,0
595,岑宁儿,0,2,2,0,0.001864512,0.138622423,0,0,0,2,2
596,CLOUDWANG,0,0,0,0,0,0,0,0,0,0,0
597,BAHERDINTURSUN,0,1,1,0,0.001243008,0.128687679,0,0,0,1,1
598,夏凌兮,1,1,2,0.001243008,0.001243008,0.099954844,0,0,1,1,2
599,DE_SCC,1,0,1,0.001243008,0,0.124023667,0,0,1,0,1
600,Motorama,0,0,0,0,0,0,0,0,0,0,0
601,DP龙猪,0,3,3,0,0.002663589,0.139838409,0,0,0,3,3
602,西楼,0,0,0,0,0,0,0,0,0,0,0
603,AdventureClub,0,0,0,0,0,0,0,0,0,0,0
604,狄奥尼索斯,0,1,1,0,0.001243008,0.152961555,0,0,0,1,1
605,沈曼,0,0,0,0,0,0,0,0,0,0,0
606,iMoon,0,18,18,0,0.019888129,0.179069787,0,0,0,18,18
607,牛奶白,0,1,1,0,0.001243008,0.128738374,0,0,0,1,1
608,胶壳,0,0,0,0,0,0,0,0,0,0,0
609,Leech,0,0,0,0,0,0,0,0,0,0,0
610,NoiseHappy,0,2,2,0,0.008844876,0.148884903,0,0,0,2,2
611,李行亮,0,0,0,0,0,0,0,0,0,0,0
612,HAYA乐团,4,0,4,0.002983219,0,0.155842805,1,0,4,0,4
613,庙乐队,1,1,2,0.001243008,0.001243008,0.001864512,0,3.87E-07,1,1,2
614,魏新雨,0,0,0,0,0,0,0,0,0,0,0
615,AHKEXl,1,0,1,0.001243008,0,0.153897981,13,0,1,0,1
616,Winky诗,4,1,5,0.002693184,0.001243008,0.15143761,0,5.03E-06,4,1,5
617,一针见喜,1,0,1,0.001243008,0,0.15444346,0,0,1,0,1
618,一盛,2,0,2,0.001864512,0,0.131668961,0,0,2,0,2
619,安妮朵拉,0,0,0,0,0,0,0,0,0,0,0
620,Riyo橙,0,1,1,0,0.001243008,0.119140489,0,0,0,1,1
621,清风至,0,14,14,0,0.009529729,0.15711652,0,0,0,14,14
622,白桦树娃娃,2,0,2,0.003080498,0,0.141228333,0,0,2,0,2
623,NGHTMRE,15,0,15,0.011791779,0,0.177128651,0,0,15,0,15
624,吴琼,0,0,0,0,0,0,20,0,0,0,0
625,与非门乐队,5,1,6,0.00334656,0.001243008,0.152889994,0,7.74E-06,5,1,6
626,张彵凡,2,0,2,0.00207168,0,0.137024051,0,0,2,0,2
627,FOM,0,1,1,0,0.001243008,0.145828809,0,0,0,1,1
628,丁爽,0,0,0,0,0,0,0,0,0,0,0
629,JiessieZhang,0,1,1,0,0.001243008,0.111195087,0,0,0,1,1
630,JamesBlunt,0,0,0,0,0,0,0,0,0,0,0
631,喵步小雨中,1,0,1,0.00149161,0,0.111289754,0,0,1,0,1
632,徐海榕,0,0,0,0,0,0,8,0,0,0,0
633,黄雨篱,1,7,8,0.001243008,0.004972032,0.157419249,0,3.10E-06,2,7,9
634,南瓜妮歌迷俱乐部,0,0,0,0,0,0,0,0,0,0,0
635,初初初夏W,0,5,5,0,0.003729024,0.163975094,0,0,0,5,5
636,曾大块儿,0,7,7,0,0.009845932,0.161543431,0,0,0,7,7
637,DYGL,0,0,0,0,0,0,0,0,0,0,0
638,Doris小武,1,0,1,0.001243008,0,0.12157826,0,0,1,0,1
639,潘广益,0,0,0,0,0,0,0,0,0,0,0
640,吴越,0,3,3,0,0.006282595,0.161105429,0,0,0,3,3
641,白举纲,0,1,1,0,0.001243008,0.145991674,0,0,0,1,1
642,普映蒙,1,0,1,0.001243008,0,0.153897981,0,0,1,0,1
643,Brila_L,0,1,1,0,0.001243008,0.001243008,0,0,0,1,1
644,U.TA,0,0,0,0,0,0,0,0,0,0,0
645,Round_,1,0,1,0.001243008,0,0.134045267,0,0,1,0,1
646,笨笨口琴,0,1,1,0,0.001243008,0.001243008,0,0,0,1,1
647,非樂原创音乐工作室,0,1,1,0,0.008943595,0.135630779,0,0,0,1,1
648,东来东往,0,1,1,0,0.001243008,0.1259354,0,0,0,1,1
649,二文,0,1,1,0,0.001243008,0.001243008,0,0,0,1,1
650,Herobust,0,0,0,0,0,0,0,0,0,0,0
651,F-FAX,0,2,2,0,0.001864512,0.147374233,0,0,0,2,2
652,张叶蕾,0,0,0,0,0,0,0,0,0,0,0
653,苏妙玲,0,0,0,0,0,0,0,0,0,0,0
654,残泪杰,0,1,1,0,0.001243008,0.124000137,0,0,0,1,1
655,痛仰乐队,6,0,6,0.004917988,0,0.147673909,0,0,6,0,6
656,何故乐队,0,5,5,0,0.003729024,0.166015932,0,0,0,5,5
657,羽·泉,0,1,1,0,0.001243008,0.128992446,0,0,0,1,1
658,斯琴塔那,0,0,0,0,0,0,0,0,0,0,0
659,张瑶,0,0,0,0,0,0,0,0,0,0,0
660,白白麦,1,0,1,0.001243008,0,0.11778784,1.5,0,1,0,1
661,萨顶顶,2,1,3,0.001864512,0.001243008,0.149566298,0,5.80E-07,2,1,3
662,少司命,1,0,1,0.001243008,0,0.1506696,0,0,1,0,1
663,茉莉僧,0,10,10,0,0.010618239,0.155139977,0,0,0,10,10
664,ariadeng,0,1,1,0,0.005607348,0.154188423,0,0,0,1,1
665,孙国庆,0,0,0,0,0,0,0,0,0,0,0
666,展展与罗罗,0,0,0,0,0,0,0,0,0,0,0
667,鬼卞,9,0,9,0.006642324,0,0.167935438,0,0,9,0,9
668,尹姝贻,0,0,0,0,0,0,0,0,0,0,0
669,爱朵女孩,0,1,1,0,0.001243008,0.001243008,0,0,0,1,1
670,顾峰,0,2,2,0,0.001864512,0.151718831,0,0,0,2,2
671,因可INCHAOS,1,0,1,0.001243008,0,0.134597348,0,0,1,0,1
672,七朵组合,1,0,1,0.001243008,0,0.125187651,0,0,1,0,1
673,狂奔的萝卜,0,5,5,0,0.006044431,0.164016242,0,0,0,5,5
674,TINGSHIGHUCH,1,0,1,0.001243008,0,0.114687616,1,0,1,0,1
675,瓶中怪,1,1,2,0.001243008,0.001243008,0.12169144,0,3.87E-07,1,1,2
676,简弘亦,6,0,6,0.004350528,0,0.153934226,0,0,6,0,6
677,Tolein,6,0,6,0.00466128,0,0.1806536,0,0,6,0,6
678,弗雷德乐队FD,1,0,1,0.001243008,0,0.11778784,0,0,1,0,1
679,HOYO-MiX,0,0,0,0,0,0,0,0,0,0,0
680,伞妹,0,1,1,0,0.001243008,0.133497697,15,0,0,1,1
681,ETAGI,3,1,4,0.002486016,0.001243008,0.139808497,1236.683,5.80E-06,4,1,5
682,Anti-General,45,7,52,0.032205209,0.00757834,0.203298514,0,4.79E-04,59,7,66
683,Explosicum,0,2,2,0,0.001864512,0.142459617,0,0,0,2,2
684,小青龙,0,1,1,0,0.00367498,0.134902936,18,0,0,1,1
685,Namunong,2,5,7,0.001775726,0.003729024,0.137485217,0,6.97E-06,2,5,7
686,Husan,0,2,2,0,0.004972032,0.157229907,0,0,0,2,2
687,悬铃木,1,0,1,0.001243008,0,0.137600994,0,0,1,0,1
688,Y.A,0,4,4,0,0.002486016,0.145310076,0,0,0,4,4
689,Senpai,0,0,0,0,0,0,190,0,0,0,0
690,李迦南Doc,13,7,20,0.008286721,0.004972032,0.171055934,0,7.35E-05,13,7,20
691,何星烁RapStar,2,0,2,0.011961021,0,0.136823262,0,0,2,0,2
692,RhapsodyofFire,0,0,0,0,0,0,0,0,0,0,0
693,阿来,0,1,1,0,0.001243008,0.125163677,0,0,0,1,1
694,清华大学键盘队,0,0,0,0,0,0,0,0,0,0,0
695,绾绾Akari,1,0,1,0.001243008,0,0.001243008,0,0,1,0,1
696,文劲松,0,1,1,0,0.001243008,0.133497697,1,0,0,1,1
697,曾一鸣,1,1,2,0.001243008,0.001243008,0.129349836,0,3.87E-07,1,1,2
698,叶雨蒙,0,0,0,0,0,0,0,0,0,0,0
699,LunaSafari,0,1,1,0,0.001243008,0.001243008,0,0,0,1,1
700,秋野,0,1,1,0,0.001243008,0.102205586,0,0,0,1,1
701,Eddd,0,15,15,0,0.011484545,0.172911302,0.5,0,0,15,15
702,满文军,1,1,2,0.001243008,0.001243008,0.150878283,0,1.93E-07,1,1,2
703,BEAUZ,0,0,0,0,0,0,0,0,0,0,0
704,衣湿乐队,4,0,4,0.00310752,0,0.154297621,16,0,4,0,4
705,阿良良木健,1,6,7,0.001243008,0.006988468,0.18328792,0,6.19E-06,1,6,7
706,LudovicoEinaudi,0,0,0,0,0,0,28,0,0,0,0
707,Ferrison,1,2,3,0.001243008,0.00535355,0.146154902,0,1.08E-05,2,2,4
708,杨梓琪呀,0,0,0,0,0,0,0,0,0,0,0
709,GulgineMollaemet,0,1,1,0,0.001243008,0.128687679,0,0,0,1,1
710,黑薄荷乐队,2,0,2,0.001864512,0,0.156066075,0,0,2,0,2
711,玥霖Gabrielle,5,0,5,0.004825796,0,0.149703326,0,0,7,0,7
712,AxwellΛIngrosso,0,0,0,0,0,0,0,0,0,0,0
713,雪沉乐队,1,0,1,0.001243008,0,0.001243008,0,0,1,0,1
714,简迷离GEMINI,2,0,2,0.001864512,0,0.155103162,0,0,2,0,2
715,Beverly,0,0,0,0,0,0,0,0,0,0,0
716,五条人,4,0,4,0.00310752,0,0.143083346,0,0,4,0,4
717,周栈,0,3,3,0,0.002663589,0.156890236,0,0,0,3,3
718,盘大王,0,2,2,0,0.001864512,0.153212547,0,0,0,2,2
719,MartinJensen,0,0,0,0,0,0,0,0,0,0,0
720,汪苏泷,3,0,3,0.002486016,0,0.139183289,0,0,3,0,3
721,清弄,0,0,0,0,0,0,0,0,0,0,0
722,刘嘉亮,0,1,1,0,0.001243008,0.128992446,0,0,0,1,1
723,王栎鑫,0,0,0,0,0,0,0,0,0,0,0
724,小柯,3,0,3,0.002486016,0,0.146778514,0,0,3,0,3
725,eveningcinema,0,0,0,0,0,0,0,0,0,0,0
726,孔令奇,3,0,3,0.002486016,0,0.146482457,0,0,3,0,3
727,千界,0,2,2,0,0.001864512,0.137833134,0,0,0,4,4
728,漏音器TheLowincher,0,5,5,0,0.003729024,0.14364939,0,0,0,5,5
729,Koowho,1,4,5,0.001243008,0.00310752,0.16771997,0,0,1,4,5
730,小亨,0,1,1,0,0.001243008,0.001243008,0,0,0,1,1
731,EmilyStyler,0,0,0,0,0,0,0,0,0,0,0
732,MarianHill,0,0,0,0,0,0,0,0,0,0,0
733,DahliaRosea(玫瑰博士),0,1,1,0,0.001243008,0.001243008,0,0,0,1,1
734,MuSikI,0,2,2,0,0.001864512,0.132041358,0,0,0,2,2
735,YoungTime,0,1,1,0,0.002693184,0.115866819,0,0,0,1,1
736,郑茜匀,0,0,0,0,0,0,0,0,0,0,0
737,幻華楽,1,0,1,0.001243008,0,0.126471502,0.5,0,1,0,1
738,康智炜,1,3,4,0.001243008,0.002983219,0.130044712,0,1.93E-07,1,3,4
739,MandoDiao,0,0,0,0,0,0,0,0,0,0,0
740,孙楠,5,0,5,0.009353636,0,0.15317664,0,0,5,0,5
741,付春霞,0,0,0,0,0,0,0,0,0,0,0
742,Fumos,1,0,1,0.001243008,0,0.126154164,0,0,1,0,1
743,白静晨,0,1,1,0,0.001243008,0.105898367,0,0,0,1,1
744,王嘉尔,10,0,10,0.006869255,0,0.176268804,0,0,10,0,10
745,黄雅莉,0,0,0,0,0,0,0,0,0,0,0
746,FACEV?ID,0,2,2,0,0.004587292,0.144859203,0,0,0,4,4
747,满汉全席,0,1,1,0,0.001243008,0.136794626,0,0,0,1,1
748,王愚,0,1,1,0,0.00155376,0.113967694,0,0,0,1,1
749,神马乐团,0,0,0,0,0,0,0,0,0,0,0
750,千夜,0,0,0,0,0,0,0,0,0,0,0
751,张赫宣,1,0,1,0.001243008,0,0.139183289,0,0,1,0,1
752,二龙湖浩哥,0,0,0,0,0,0,0,0,0,0,0
753,ShitheaD,0,2,2,0,0.001864512,0.11646556,0,0,0,2,2
754,蒋道理,0,1,1,0,0.001243008,0.143271531,0,0,0,1,1
755,HAMY何美延,0,2,2,0,0.00207168,0.139748711,0,0,0,2,2
756,YellowClaw,0,2,2,0,0.001864512,0.128941551,0,0,0,2,2
757,JOE,0,8,8,0,0.006705072,0.154882636,0,0,0,8,8
758,刘惜君,2,0,2,0.001847715,0,0.153608631,0,0,2,0,2
759,方迩羲,0,0,0,0,0,0,0,0,0,0,0
760,WARISJANABDUREHIM,0,1,1,0,0.001243008,0.120236336,0,0,0,1,1
761,安来宁,3,0,3,0.003442176,0,0.147175123,0,0,3,0,3
762,祁汉,0,5,5,0,0.003729024,0.169108596,0,0,0,5,5
763,Rhye,0,0,0,0,0,0,0,0,0,0,0
764,rising,0,0,0,0,0,0,0,0,0,0,0
765,厦门六中合唱团,1,0,1,0.001243008,0,0.001243008,0,0,1,0,1
766,Tobu,0,0,0,0,0,0,0,0,0,0,0
767,陈小虎,0,1,1,0,0.001243008,0.103598783,0,0,0,1,1
768,DJCarnage,0,0,0,0,0,0,0,0,0,0,0
769,PRCrew,0,1,1,0,0.001243008,0.128561118,0,0,0,1,1
770,卫彬月,0,3,3,0,0.00852091,0.147673909,0,0,0,3,3
771,ZaleLes,3,0,3,0.002486016,0,0.140711458,0,0,3,0,3
772,索朗旺姆,0,0,0,0,0,0,192,0,0,0,0
773,初夏小溪,4,6,10,0.00310752,0.011373192,0.172227859,0,7.43E-05,4,6,10
774,沈庆,8,0,8,0.004568895,0,0.153717009,0,0,8,0,8
775,Arman,2,0,2,0.014905908,0,0.141045473,0,0,2,0,2
776,诱导社,0,1,1,0,0.001243008,0.131351432,0,0,0,1,1
777,茉茉天空,0,2,2,0,0.006133722,0.145504168,0,0,0,2,2
778,盘尼西林,0,0,0,0,0,0,0,0,0,0,0
779,DJ-荣大大,0,2,2,0,0.001864512,0.143146019,0,0,0,2,2
780,Owen,0,1,1,0,0.001243008,0.115294536,0,0,0,1,1
781,秦万民,0,1,1,0,0.001243008,0.125163677,0,0,0,1,1
782,Truart,0,0,0,0,0,0,0,0,0,0,0
783,ViniVici,0,0,0,0,0,0,0,0,0,0,0
784,喵酱mio,0,2,2,0,0.001864512,0.136594509,0,0,0,2,2
785,Q.luv,0,1,1,0,0.001243008,0.128561118,0,0,0,2,2
786,洪尘,1,0,1,0.001243008,0,0.15444346,0,0,1,0,1
787,Maxone老虎,1,0,1,0.001243008,0,0.001243008,0,0,1,0,1
788,高安,0,0,0,0,0,0,0,0,0,0,0
789,李慧宇,3,0,3,0.011993348,0,0.158219492,0,0,3,0,3
790,付浩天,0,0,0,0,0,0,0,0,0,0,0
791,彭博,0,0,0,0,0,0,0,0,0,0,0
792,Riyatjan-Muhammat,1,0,1,0.001243008,0,0.134569636,0,0,2,0,2
793,艾美琦,0,0,0,0,0,0,2,0,0,0,0
794,impossibleChuck,1,3,4,0.001243008,0.006282595,0.177561729,0,7.74E-07,1,3,4
795,阿涵,0,0,0,0,0,0,0,0,0,0,0
796,Knight,0,3,3,0,0.004723431,0.15444346,0,0,0,3,3
797,LosCrasher,0,0,0,0,0,0,0,0,0,0,0
798,曲艺,0,0,0,0,0,0,0,0,0,0,0
799,才让东珠,0,0,0,0,0,0,0,0,0,0,0
800,咖啡因乐队,1,0,1,0.001243008,0,0.134597348,8,0,1,0,1
801,DjCore,1,8,9,0.001243008,0.008243106,0.176602195,0,3.10E-06,1,8,9
802,李晋,1,0,1,0.002130871,0,0.137398512,0,0,1,0,1
803,潘雨轩,0,1,1,0,0.00581634,0.143902405,0,0,0,1,1
804,醒山工作室,0,8,8,0,0.00569712,0.172001243,0,0,0,8,8
805,马马,0,0,0,0,0,0,0,0,0,0,0
806,郁可唯,1,0,1,0.001243008,0,0.12630043,0,0,1,0,1
807,江一燕,0,0,0,0,0,0,0,0,0,0,0
808,可儿,0,0,0,0,0,0,0,0,0,0,0
809,RTG,0,2,2,0,0.00207168,0.114566998,0,0,0,2,2
810,XINZHU,0,1,1,0,0.002486016,0.113119544,0,0,0,1,1
811,秦洋,0,3,3,0,0.004101927,0.162225049,0,0,0,3,3
812,吕雯,0,0,0,0,0,0,0,0,0,0,0
813,蒋山,2,0,2,0.00349596,0,0.143870729,0,0,2,0,2
814,Omi,2,0,2,0.001864512,0,0.124354019,0,0,2,0,2
815,K.P.R.,0,2,2,0,0.00207168,0.130694806,0,0,0,2,2
816,AgNo,0,2,2,0,0.001864512,0.155694312,0,0,0,3,3
817,SAFIA,0,0,0,0,0,0,0,0,0,0,0
818,陈壹千,0,1,1,0,0.006264761,0.130381952,0,0,0,1,1
819,萧煌奇,1,0,1,0.001243008,0,0.116944842,0,0,1,0,1
820,晴天,0,1,1,0,0.001243008,0.113532174,0,0,0,1,1
821,iimmune,2,0,2,0.001864512,0,0.153753169,0,0,2,0,2
822,显然乐队,0,0,0,0,0,0,0,0,0,0,0
823,枫叶,0,0,0,0,0,0,0,0,0,0,0
824,ANATOMOD,2,1,3,0.019902096,0.005339285,0.158066439,0,0,2,2,4
825,余枫,0,6,6,0,0.004350528,0.159182836,0,0,0,6,6
826,MIC男团,1,0,1,0.001243008,0,0.134486569,0,0,1,0,1
827,尚雯婕,29,0,29,0.025912357,0,0.193488669,0,0,29,0,29
828,鲸鱼马戏团,0,4,4,0,0.00310752,0.158334478,0,0,0,4,4
829,排骨教主,5,0,5,0.00656032,0,0.154516483,0,0,5,0,5
830,晃儿,0,0,0,0,0,0,0,0,0,0,0
831,EdSheeran,0,0,0,0,0,0,0,0,0,0,0
832,王梵瑞,0,1,1,0,0.001243008,0.120480133,76,0,0,2,2
833,Akie秋绘,5,8,13,0.004068026,0.005859895,0.181859968,0,2.94E-05,5,8,13
834,段同愿,3,0,3,0.002486016,0,0.144923442,0,0,3,0,3
835,阿岛先生,1,0,1,0.001243008,0,0.001243008,0,0,3,0,3
836,MajorLazer,0,0,0,0,0,0,0,0,0,0,0
837,冰鑫,0,1,1,0,0.001243008,0.152961555,0,0,0,1,1
838,波比,0,4,4,0,0.006242062,0.164801998,15,0,0,4,4
839,丁炜,3,2,5,0.002900352,0.002175264,0.129838046,0,5.80E-06,3,2,5
840,唐古,0,1,1,0,0.001243008,0.128992446,0,0,0,1,1
841,安然,0,1,1,0,0.001243008,0.139748711,0,0,0,1,1
842,么么,0,8,8,0,0.005593536,0.170120959,0,0,0,8,8
843,松果日记乐队,0,1,1,0,0.001243008,0.132335437,0,0,0,1,1
844,徐歌阳,1,0,1,0.001243008,0,0.128916119,0,0,1,0,1
845,赵雷,0,0,0,0,0,0,0,0,0,0,0
846,光速飞行,0,2,2,0,0.001864512,0.001864512,0,0,0,2,2
847,吴文煜,0,0,0,0,0,0,0,0,0,0,0
848,LGlywww,1,0,1,0.001243008,0,0.110987387,0,0,1,0,1
849,樹莓蛋奶酥,1,0,1,0.001243008,0,0.001243008,0,0,1,0,1
850,才姆措,1,0,1,0.001243008,0,0.001243008,0,0,1,0,1
851,陈浩民,0,0,0,0,0,0,0,0,0,0,0
852,良人乐团,1,0,1,0.001243008,0,0.001243008,0,0,1,0,1
853,爱乐团王超,0,0,0,0,0,0,0,0,0,0,0
854,SwedishHouseMafia,0,0,0,0,0,0,0,0,0,0,0
855,シャムキャッツ,0,0,0,0,0,0,0,0,0,0,0
856,王若琳,0,0,0,0,0,0,0,0,0,0,0
857,弘诺方舟,0,0,0,0,0,0,0,0,0,0,0
858,冉明阳,0,1,1,0,0.001243008,0.133716187,0,0,0,1,1
859,DAVIDBORING,0,0,0,0,0,0,0,0,0,0,0
860,天空乐队,1,0,1,0.001243008,0,0.128966994,0,0,1,0,1
861,LostStories,0,0,0,0,0,0,0,0,0,0,0
862,邓文怡,0,0,0,0,0,0,0,0,0,0,0
863,燕池,3,0,3,0.006551688,0,0.15364474,197,0,3,0,3
864,焦迈奇,7,3,10,0.004972032,0.006191587,0.164677431,0,7.62E-05,10,3,13
865,邱小龙,0,3,3,0,0.002486016,0.145407057,0,0,0,3,3
866,郑钧,0,0,0,0,0,0,0,0,0,0,0
867,董冬冬,0,0,0,0,0,0,0,0,0,0,0
868,Monica不不,1,0,1,0.001243008,0,0.105454134,0,0,1,0,1
869,梅粮新,2,0,2,0.002610317,0,0.117872809,0,0,2,0,2
870,TimmyTrumpet,0,1,1,0,0.001243008,0.13876958,0,0,0,1,1
871,Hoaprox,0,0,0,0,0,0,0,0,0,0,0
872,Bangz,19,0,19,0.015238801,0,0.187817449,8.167,0,19,0,19
873,Nellee,1,2,3,0.001243008,0.006080256,0.141075917,0,3.16E-06,1,2,3
874,CocoPop,0,0,0,0,0,0,0,0,0,0,0
875,黄征,0,0,0,0,0,0,0,0,0,0,0
876,林如韵,0,1,1,0,0.00149161,0.134182863,0,0,0,1,1
877,言吾音,0,0,0,0,0,0,2,0,0,0,0
878,拖鞋pd,2,1,3,0.001864512,0.001243008,0.134847271,0,7.74E-07,2,1,3
879,过又嘉,0,0,0,0,0,0,0,0,0,0,0
880,Veeos,0,8,8,0,0.007904257,0.164843562,0,0,0,8,8
881,冷冻街,3,0,3,0.002486016,0,0.155139977,0,0,3,0,3
882,Mzoce,0,2,2,0,0.001864512,0.143271531,0,0,0,2,2
883,阎奕格,0,0,0,0,0,0,17,0,0,0,0
884,傅酥,2,2,4,0.001864512,0.003633408,0.139035253,17,6.58E-06,2,3,5
885,知性的小方块,5,2,7,0.003729024,0.001864512,0.138534278,0,6.58E-06,5,2,7
886,暮色绽放,0,1,1,0,0.001243008,0.116424069,0,0,0,1,1
887,李粟,0,6,6,0,0.004350528,0.169723377,0,0,0,6,6
888,二嘉,0,3,3,0,0.00379808,0.159610433,0,0,0,3,3
889,桃十五,0,1,1,0,0.001243008,0.132738571,0,0,0,1,1
890,MKJ,8,0,8,0.005932539,0,0.159415786,0,0,8,0,8
891,窒息乐队,0,0,0,0,0,0,0,0,0,0,0
892,Bassjackers,0,0,0,0,0,0,0,0,0,0,0
893,脆乐团,0,0,0,0,0,0,0,0,0,0,0
894,丁乔,0,5,5,0,0.007001433,0.160630308,10,0,0,5,5
895,ChenDjoy,1,8,9,0.001243008,0.005859895,0.175842003,0,3.87E-06,1,8,9
896,AlimjanTursun,0,3,3,0,0.005800704,0.16463595,0,0,0,3,3
897,Easion_Ng,0,1,1,0,0.006007872,0.140984625,0,0,0,1,1
898,Axero,0,0,0,0,0,0,0,0,0,0,0
899,陈鸿宇,0,10,10,0,0.01081417,0.171684981,49,0,0,10,10
900,积木立方,2,7,9,0.001864512,0.00792113,0.174854126,0,1.90E-05,2,7,9
901,卡斯Kas$,0,1,1,0,0.002563704,0.135828081,0,0,0,1,1
902,范星光,0,0,0,0,0,0,0,0,0,0,0
903,熊猫团PandaBros,0,1,1,0,0.00155376,0.112052927,0,0,0,1,1
904,Flosstradamus,12,0,12,0.016505517,0,0.168064984,0,0,12,0,12
905,KatieGoestoTokyo,0,0,0,0,0,0,0,0,0,0,0
906,洪雨雷,0,0,0,0,0,0,4,0,0,0,0
907,Shahimerdan麦尔丹,1,5,6,0.001243008,0.003729024,0.144987738,6,1.55E-06,1,5,6
908,DeeShne,2,1,3,0.001775726,0.001740211,0.11302174,0,2.32E-06,2,1,3
909,万能青年,0,3,3,0,0.002486016,0.147774073,0,0,0,3,3
910,贾孟昕,0,0,0,0,0,0,0,0,0,0,0
911,谦木,0,6,6,0,0.008390305,0.161623324,12,0,0,6,6
912,BeeXXXX,2,2,4,0.00207168,0.002610317,0.11426656,0,4.64E-06,2,2,4
913,卜小可,1,0,1,0.001243008,0,0.13048607,0,0,1,0,1
914,Faye飞,0,0,0,0,0,0,0,0,0,0,0
915,DJSnake,0,0,0,0,0,0,0,0,0,0,0
916,Inspirative,0,0,0,0,0,0,4,0,0,0,0
917,Mllano,1,4,5,0.001243008,0.00310752,0.156739742,0,1.55E-06,1,4,5
918,ImmanuEl,0,0,0,0,0,0,0,0,0,0,0
919,Noicybino,8,0,8,0.005829279,0,0.141656854,0,0,8,0,8
920,杨宗纬,6,0,6,0.004474829,0,0.158911919,33,0,6,0,6
921,陆本平,1,16,17,0.001243008,0.010613377,0.181405696,106,1.28E-05,1,16,17
922,CNBALLER,6,2,8,0.010517761,0.00207168,0.142677303,0,4.10E-05,7,2,9
923,愚青,2,0,2,0.001864512,0,0.127160452,124,0,2,0,2
924,曾楠,3,8,11,0.003314688,0.005703214,0.165093388,0,4.80E-05,3,8,11
925,UN组合,1,0,1,0.001243008,0,0.001243008,0,0,1,0,1
926,鲍越,0,12,12,0,0.008079553,0.177128651,0,0,0,12,12
927,梵墨,0,0,0,0,0,0,0,0,0,0,0
928,泠鸢yousa,0,1,1,0,0.001243008,0.144379219,0,0,0,1,1
929,士辉,0,4,4,0,0.005360472,0.167676943,0,0,0,4,4
930,魏晨,1,0,1,0.002532053,0,0.111365603,0,0,1,0,1
931,米线,0,0,0,0,0,0,103,0,0,0,0
932,姚贝娜,9,2,11,0.008079553,0.00207168,0.161145149,0,3.99E-05,9,2,11
933,摩登兄弟,0,0,0,0,0,0,0,0,0,0,0
934,乔洋,0,0,0,0,0,0,0,0,0,0,0
935,Rezz,0,0,0,0,0,0,0,0,0,0,0
936,潘柯夫,0,0,0,0,0,0,0,0,0,0,0
937,JuicyJ,0,0,0,0,0,0,9,0,0,0,0
938,Assen捷,3,3,6,0.002486016,0.002486016,0.144092752,0,3.48E-06,3,3,6
939,Yileen,0,1,1,0,0.001243008,0.126790441,96,0,0,1,1
940,Aki阿杰,5,2,7,0.006072982,0.002486016,0.167419243,0,3.72E-05,5,2,7
941,胡彦斌,7,0,7,0.006675414,0,0.175276139,0,0,7,0,7
942,精彩词轩,0,5,5,0,0.00492024,0.15001256,0,0,0,5,5
943,安子与九妹,6,0,6,0.005932539,0,0.160986385,0,0,6,0,6
944,阿爆,0,0,0,0,0,0,414.667,0,0,0,0
945,RCKY,19,7,26,0.023775658,0.006436398,0.194178468,0,1.60E-04,20,7,27
946,任家萱,0,0,0,0,0,0,0,0,0,0,0
947,马小野乐队,1,0,1,0.001243008,0,0.001243008,0,0,1,0,1
948,BreatheCarolina,0,0,0,0,0,0,0,0,0,0,0
949,刘明汉,0,0,0,0,0,0,285.5,0,0,0,0
950,茶季杨,7,2,9,0.004972032,0.009787801,0.146844467,0,1.10E-04,8,2,10
951,李瑨瑶,0,1,1,0,0.001243008,0.150323073,0,0,0,1,1
952,尹吾,0,3,3,0,0.002486016,0.152604418,17,0,0,3,3
953,白噪音乐队,3,1,4,0.005004743,0.001243008,0.154079378,0,6.58E-06,3,1,4
954,严玲严莉,0,0,0,0,0,0,0,0,0,0,0
955,TheFatRat,0,0,0,0,0,0,0,0,0,0,0
956,沙宝亮,1,0,1,0.001243008,0,0.1427708,0,0,1,0,1
957,黑崎子,0,0,0,0,0,0,0,0,0,0,0
958,卫兰,4,0,4,0.003262896,0,0.150288508,0,0,4,0,4
959,偷喜办,1,0,1,0.001243008,0,0.117259549,35,0,1,0,1
960,王铮亮,1,5,6,0.001831801,0.004847732,0.143554738,0,1.35E-05,1,5,6
961,张拾壹,0,1,1,0,0.00149161,0.113139125,0,0,0,1,1
962,VIVI,0,0,0,0,0,0,0,0,0,0,0
963,耀乐团,5,0,5,0.018114299,0,0.172227859,0,0,5,0,5
964,VISUDY,14,0,14,0.012204079,0,0.183339333,0,0,14,0,14
965,锦零,5,0,5,0.003729024,0,0.178922727,0,0,5,0,5
966,YehudiToo,0,10,10,0,0.012299238,0.169679316,0,0,0,10,10
967,InfiniteMusic,6,0,6,0.004350528,0,0.16989985,0,0,6,0,6
968,蜜蜂少女队,0,0,0,0,0,0,0,0,0,0,0
969,千月兔,4,0,4,0.003442176,0,0.134045267,0,0,6,0,6
970,破音,0,0,0,0,0,0,190,0,0,0,0
971,Tacke竹桑,5,1,6,0.004557696,0.004474829,0.145568981,0,7.35E-05,5,1,6
972,许魏洲,0,0,0,0,0,0,0,0,0,0,0
973,龙梅子,0,1,1,0,0.001243008,0.128992446,0,0,0,1,1
974,GillChang,0,0,0,0,0,0,0,0,0,0,0
975,老虎欧巴,0,9,9,0,0.006251599,0.162144561,0,0,0,9,9
976,SHEKHINAH|安娜与陈飙,0,1,1,0,0.001243008,0.001243008,0,0,0,1,1
977,徐良,3,0,3,0.002486016,0,0.153897981,0,0,3,0,3
978,西奥Sio,8,0,8,0.014040918,0,0.161304226,0,0,8,0,8
979,毛衍七Vava,0,1,1,0,0.001243008,0.129196427,0,0,0,1,1
980,刘昊霖,8,0,8,0.010219362,0,0.152142626,0,0,8,0,8
981,韩安旭,0,0,0,0,0,0,0,0,0,0,0
982,虎二,0,1,1,0,0.00310752,0.146154902,0,0,0,1,1
983,PINAR,0,0,0,0,0,0,0,0,0,0,0
984,兰眼睛女子乐团,0,1,1,0,0.001243008,0.139420803,0,0,0,1,1
985,Soler,0,0,0,0,0,0,0,0,0,0,0
986,吉克曲布,0,0,0,0,0,0,0,0,0,0,0
987,肆囍乐队,4,0,4,0.016682477,0,0.159961998,0,0,4,0,4
988,BRGang,4,0,4,0.00669312,0,0.150357654,0,0,4,0,4
989,爱戴,0,0,0,0,0,0,0,0,0,0,0
990,彭宇,0,4,4,0,0.00310752,0.153320367,0,0,0,4,4
991,董昱昆,0,7,7,0,0.007012792,0.17083239,0,0,0,7,7
992,回音哥,0,1,1,0,0.001243008,0.11426656,0,0,0,1,1
993,李蚊香,4,0,4,0.003480423,0,0.130277999,0,0,4,0,4
994,新疆群星,0,1,1,0,0.00149161,0.107980295,0,0,0,1,1
995,梁博,0,0,0,0,0,0,0,0,0,0,0
996,莫爱河往生,0,1,1,0,0.001243008,0.13685191,0,0,0,1,1
997,ReturnTheTruth,0,1,1,0,0.00310752,0.146154902,118,0,0,1,1
998,白天不亮,6,7,13,0.004350528,0.006525792,0.184165884,0,4.57E-05,6,7,13
999,马里奥赛德,0,6,6,0,0.004350528,0.155731409,0,0,0,6,6
1000,FabianMazur,0,0,0,0,0,0,0,0,0,0,0
1001,于嘉萌,0,2,2,0,0.001864512,0.146877466,0,0,0,2,2
1002,金培达,0,0,0,0,0,0,0,0,0,0,0
1003,马雨阳,10,0,10,0.007975969,0,0.175417263,0,0,18,0,18
1004,夏子皓,0,1,1,0,0.00149161,0.096544272,0,0,0,1,1
1005,MattZachary,0,3,3,0,0.004101927,0.1528185,0,0,0,3,3
1006,AndyMei,0,2,2,0,0.001864512,0.154370506,0,0,0,2,2
1007,李汶峰,0,2,2,0,0.001864512,0.156777338,0,0,0,2,2
1008,泠风,0,6,6,0,0.00734029,0.17136988,0,0,0,6,6
1009,_Stefano,0,5,5,0,0.003729024,0.149669046,0,0,0,5,5
1010,小雨乐队,1,0,1,0.002900352,0,0.123344919,0,0,1,0,1
1011,赵鑫,0,0,0,0,0,0,0,0,0,0,0
1012,闫东炜,8,0,8,0.005703214,0,0.175700194,0,0,8,0,8
1013,苏阳,3,0,3,0.003729024,0,0.145180969,0,0,3,0,3
1014,Prismo,0,0,0,0,0,0,0,0,0,0,0
1015,蔡徐坤,0,0,0,0,0,0,361.85,0,0,0,0
1016,PIKLANS,8,7,15,0.017624741,0.00722857,0.185525042,0,1.40E-04,8,7,15
1017,#NAME?,0,0,0,0,0,0,0,0,0,0,0
1018,满江,2,0,2,0.001864512,0,0.131828302,0,0,2,0,2
1019,任路加,1,0,1,0.001243008,0,0.124047205,0,0,1,0,1
1020,JonyJ,0,2,2,0,0.001864512,0.14747399,0,0,0,2,2
1021,雷诺儿,0,1,1,0,0.001243008,0.1259354,0,0,0,1,1
1022,末小皮,0,1,1,0,0.001243008,0.152961555,0,0,0,1,1
1023,腾格尔,0,0,0,0,0,0,0,0,0,0,0
1024,栗先达,4,0,4,0.00501984,0,0.151367467,1284,0,6,0,6
1025,老狼,29,12,41,0.022146369,0.008747094,0.20166761,3,4.97E-04,29,12,41
1026,姜贰拾,2,2,4,0.001864512,0.001864512,0.157457173,26.75,1.16E-06,2,2,4
1027,SixPoorGuy,2,11,13,0.001864512,0.015072696,0.189176476,0,1.04E-05,2,11,13
1028,GAI周延,0,1,1,0,0.004624721,0.148411608,0,0,0,1,1
1029,左安西西,0,0,0,0,0,0,0,0,0,0,0
1030,周深,0,0,0,0,0,0,0,0,0,0,0
1031,H.M.Funk,0,2,2,0,0.001864512,0.150288508,8,0,0,2,2
1032,六甲番,2,1,3,0.002315741,0.002938019,0.13103543,0,3.10E-06,2,1,3
1033,税子洺,0,1,1,0,0.001243008,0.097874322,0,0,0,1,1
1034,蔡方萌,0,1,1,0,0.001243008,0.109591671,0,0,0,1,1
1035,废埕乐团,0,0,0,0,0,0,0,0,0,0,0
1036,JUSF周存,2,0,2,0.00207168,0,0.154845943,0,0,2,0,2
1037,陈绮贞,0,0,0,0,0,0,0,0,0,0,0
1038,MewlanMemtimin买吾兰,0,6,6,0,0.004474829,0.139808497,0,0,0,6,6
1039,鹏泊,2,0,2,0.00207168,0,0.135209914,0,0,2,0,2
1040,王上,0,0,0,0,0,0,0,0,0,0,0
1041,邱振哲,0,0,0,0,0,0,11.5,0,0,0,0
1042,布衣乐队,7,1,8,0.014728542,0.001243008,0.166948844,0,4.45E-06,7,1,8
1043,李智,0,1,1,0,0.001243008,0.128687679,0,0,0,1,1
1044,卡列宁,0,3,3,0,0.002486016,0.154919347,0,0,0,4,4
1045,庞龙,1,0,1,0.001243008,0,0.15444346,0,0,1,0,1
1046,林小尤Simona,0,1,1,0,0.001243008,0.136224411,0,0,0,1,1
1047,乔军,0,1,1,0,0.001695011,0.128662347,0,0,0,1,1
1048,GrymeMan,0,0,0,0,0,0,0,0,0,0,0
1049,蒋敦豪,0,1,1,0,0.001243008,0.152961555,0,0,0,1,1
1050,Dirtcaps,11,0,11,0.007872385,0,0.14834424,0,0,11,0,11
1051,Anonymous,0,0,0,0,0,0,0,0,0,0,0
1052,十三妹,0,0,0,0,0,0,0,0,0,0,0
1053,Curbi,0,0,0,0,0,0,0,0,0,0,0
1054,阿朵,0,0,0,0,0,0,0,0,0,0,0
1055,KSHMR,0,1,1,0,0.001243008,0.113670387,0,0,0,1,1
1056,SkyLights,0,5,5,0,0.009965133,0.156215278,0,0,0,5,5
1057,李佳璐,0,0,0,0,0,0,0,0,0,0,0
1058,盖世Gas,1,0,1,0.001243008,0,0.128916119,0,0,1,0,1
1059,卢焱,0,1,1,0,0.001243008,0.144379219,0,0,0,1,1
1060,熊天平,0,0,0,0,0,0,0,0,0,0,0
1061,葩姐姐,0,14,14,0,0.009795646,0.161623324,0,0,0,14,14
1062,ANU,0,1,1,0,0.001243008,0.128561118,0,0,0,1,1
1063,至上励合,0,0,0,0,0,0,0,0,0,0,0
1064,Ladybeard,0,0,0,0,0,0,0,0,0,0,0
1065,YonderVoice,0,1,1,0,0.001243008,0.14001815,0,0,0,1,1
1066,谢春花,18,0,18,0.023776969,0,0.188684966,0,0,18,0,18
1067,ELYAR-PULAT,1,0,1,0.001243008,0,0.001243008,0,0,1,0,1
1068,only胡迪,0,1,1,0,0.001775726,0.124117874,2,0,0,1,1
1069,丁芙妮,1,1,2,0.001243008,0.001243008,0.14131994,0,7.74E-07,1,1,2
1070,珊瑚,0,0,0,0,0,0,0,0,0,0,0
1071,農里,0,2,2,0,0.001864512,0.147241434,0,0,0,2,2
1072,潘玮柏,2,0,2,0.001864512,0,0.161983822,0,0,2,0,2
1073,VectorMachine,0,29,29,0,0.019473793,0.197225324,69,0,0,29,29
1074,守麦,3,3,6,0.002817485,0.004407029,0.137804074,0,2.67E-05,5,3,8
1075,YYKBZ,3,0,3,0.002486016,0,0.121714101,11,0,3,0,3
1076,年姐儿,1,4,5,0.001775726,0.00310752,0.158526491,0,4.26E-06,1,4,5
1077,JasmineThompson,0,0,0,0,0,0,0,0,0,0,0
1078,yocho,0,27,27,0,0.025852811,0.197822253,0,0,0,29,29
1079,文颖秋（DJCANDY),0,1,1,0,0.001243008,0.143870729,0,0,0,1,1
1080,亚尔肯,2,0,2,0.00466128,0,0.149497878,0,0,2,0,2
1081,马天宇,1,0,1,0.001243008,0,0.112283924,848.333,0,1,0,1
1082,Killazer,9,5,14,0.020838665,0.008390305,0.180953689,0,3.28E-04,9,5,14
1083,张过年,1,0,1,0.001243008,0,0.125959669,0,0,1,0,1
1084,Soulspeak,6,0,6,0.004350528,0,0.176888964,0,0,6,0,6
1085,李荣浩,25,0,25,0.02590636,0,0.196631987,0,0,25,0,25
1086,周笔畅,1,0,1,0.001243008,0,0.001243008,8,0,1,0,1
1087,陈硕子,3,1,4,0.002486016,0.00149161,0.141995378,0,3.10E-06,3,1,4
1088,蒋雪儿,0,1,1,0,0.001243008,0.137891292,0,0,0,1,1
1089,JeamsKing,0,1,1,0,0.001243008,0.138651829,0,0,0,1,1
1090,酷癌KooEye,0,5,5,0,0.007498146,0.164801998,0,0,0,5,5
1091,DJ阿奇,0,0,0,0,0,0,0,0,0,0,0
1092,白亮,0,4,4,0,0.007522342,0.155546103,0,0,0,4,4
1093,INK,0,1,1,0,0.001243008,0.128561118,0,0,0,1,1
1094,琅琊阁,0,0,0,0,0,0,0,0,0,0,0
1095,Ezfic,0,43,43,0,0.031927844,0.203742121,0,0,0,43,43
1096,Noi!,0,2,2,0,0.001864512,0.133035767,0,0,0,2,2
1097,Orientlic,4,0,4,0.003995383,0,0.156777338,0,0,4,0,4
1098,沈波,0,1,1,0,0.001243008,0.124900578,0,0,0,1,1
1099,二直,2,0,2,0.002796768,0,0.145471784,0,0,2,0,2
1100,AscensionMusicGroup,0,0,0,0,0,0,0,0,0,0,0
1101,永彬Ryan.B,0,1,1,0,0.001243008,0.139629294,0,0,0,1,1
1102,戴佩妮,12,0,12,0.008483832,0,0.167247882,0,0,13,0,13
1103,NOSENSE无感觉,0,1,1,0,0.001243008,0.148075379,0,0,0,1,1
1104,Sawako碎花,2,0,2,0.001864512,0,0.163605688,0,0,2,0,2
1105,井宿,0,1,1,0,0.001243008,0.10839216,0,0,0,1,1
1106,白小白,0,0,0,0,0,0,0,0,0,0,0
1107,声体乐团,0,1,1,0,0.001243008,0.132738571,0,0,0,2,2
1108,五音乐队,0,2,2,0,0.001864512,0.133008694,0,0,0,2,2
1109,XON,0,9,9,0,0.00621504,0.159571466,0,0,0,9,9
1110,喷嘭乐团,0,0,0,0,0,0,0,0,0,0,0
1111,穿越君,0,1,1,0,0.001243008,0.001243008,0,0,0,1,1
1112,小峰峰,2,0,2,0.002047307,0,0.094288044,0,0,2,0,2
1113,FTampa,0,0,0,0,0,0,0,0,0,0,0
1114,RA,0,1,1,0,0.005607348,0.154188423,0,0,0,1,1
1115,Forkyrie,9,0,9,0.007102903,0,0.179561737,0,0,9,0,9
1116,甲雍,0,1,1,0,0.001243008,0.001243008,0,0,0,1,1
1117,DABANG,0,0,0,0,0,0,0,0,0,0,0
1118,InfectedMushroom,0,0,0,0,0,0,0,0,0,0,0
1119,荆纯,0,3,3,0,0.004021497,0.153970488,0,0,0,3,3
1120,只有影子,0,2,2,0,0.001864512,0.14286442,0,0,0,2,2
1121,徐佳莹,1,0,1,0.001243008,0,0.124900578,0,0,2,0,2
1122,许茹芸,0,0,0,0,0,0,4,0,0,0,0
1123,NaCl盐,2,1,3,0.006788058,0.001243008,0.099241531,0,1.55E-06,2,1,3
1124,CollisionDreamer冲撞梦想家,1,0,1,0.001243008,0,0.001243008,0,0,1,0,1
1125,海龟先生,0,0,0,0,0,0,0,0,0,0,0
1126,汪源,0,1,1,0,0.001243008,0.13560264,0,0,0,1,1
1127,Arston,0,0,0,0,0,0,0,0,0,0,0
1128,平纱落雁音乐团队,0,8,8,0,0.010164255,0.14691048,48,0,0,8,8
1129,GumJ-鸡蛋先生,7,2,9,0.004972032,0.002542517,0.1506696,0,1.86E-05,7,2,9
1130,JayHardway,0,1,1,0,0.001243008,0.120369194,0,0,0,1,1
1131,野狼乐队,0,0,0,0,0,0,0,0,0,0,0
1132,甫平,1,0,1,0.001243008,0,0.141258855,0,0,1,0,1
1133,安蕾尔,0,0,0,0,0,0,0,0,0,0,0
1134,MC水观音,0,0,0,0,0,0,0,0,0,0,0
1135,Hanser,0,2,2,0,0.005241351,0.13198803,0,0,0,2,2
1136,优雅的迟到者,0,1,1,0,0.001243008,0.151648428,0,0,0,1,1
1137,落日飞车,0,0,0,0,0,0,0,0,0,0,0
1138,李琦,2,0,2,0.001864512,0,0.131536471,0,0,2,0,2
1139,モーニング娘。,0,0,0,0,0,0,0,0,0,0,0
1140,Alok,0,0,0,0,0,0,0,0,0,0,0
1141,Audiosoldier,1,0,1,0.001243008,0,0.120858862,0,0,1,0,1
1142,栗川舜,3,0,3,0.002486016,0,0.166906211,0,0,3,0,3
1143,赵钶,2,0,2,0.001864512,0,0.115600411,0,0,2,0,2
1144,MutmeePimdao,0,0,0,0,0,0,0,0,0,0,0
1145,M-PHOTOS,4,0,4,0.01550489,0,0.148108933,68,0,5,0,5
1146,FyBe,2,9,11,0.001864512,0.008217665,0.163851773,0,2.63E-05,2,10,12
1147,黑猫,0,1,1,0,0.001243008,0.118471039,0,0,0,1,1
1148,Morrie,0,0,0,0,0,0,0,0,0,0,0
1149,棱镜,0,2,2,0,0.001864512,0.161583368,0,0,0,2,2
1150,[.que]柿本直,0,0,0,0,0,0,0,0,0,0,0
1151,eliaqsopa,8,0,8,0.005593536,0,0.161184889,0,0,8,0,8
1152,胡碧乔,0,1,1,0,0.00155376,0.113828757,0,0,0,1,1
1153,伊晗,0,1,1,0,0.001243008,0.134100272,0,0,0,1,1
1154,徐千雅,0,0,0,0,0,0,0,0,0,0,0
1155,曾小Cee,1,0,1,0.00155376,0,0.123929602,0,0,1,0,1
1156,肯别,0,3,3,0,0.005359346,0.151895125,0,0,0,3,3
1157,鹿先森乐队,4,0,4,0.00310752,0,0.144474961,0,0,4,0,4
1158,后弦,3,0,3,0.002486016,0,0.139928222,0,0,5,0,5
1159,蒋欣,0,0,0,0,0,0,0,0,0,0,0
1160,杨学,0,1,1,0,0.001243008,0.100092607,0,0,0,1,1
1161,涓子,0,0,0,0,0,0,0,0,0,0,0
1162,朴翔,0,0,0,0,0,0,0,0,0,0,0
1163,女孩与机器人,2,0,2,0.001864512,0,0.141933708,0,0,2,0,2
1164,以冬,0,3,3,0,0.003926955,0.151613251,0,0,0,3,3
1165,熊子,0,2,2,0,0.001864512,0.148783229,0,0,0,2,2
1166,陈旭,0,0,0,0,0,0,0,0,0,0,0
1167,GBZ,0,1,1,0,0.001243008,0.102221571,0,0,0,1,1
1168,TheChainsmokers,0,0,0,0,0,0,0,0,0,0,0
1169,岸部眞明,0,0,0,0,0,0,0,0,0,0,0
1170,周二下午谁没来,1,0,1,0.001243008,0,0.134597348,0,0,1,0,1
1171,彭雪,0,0,0,0,0,0,0,0,0,0,0
1172,二珂,0,0,0,0,0,0,0,0,0,0,0
1173,Grams,7,0,7,0.004972032,0,0.175794708,0,0,7,0,7
1174,懒猫乐队,0,9,9,0,0.009739334,0.164263565,0,0,0,9,9
1175,王蓉,0,0,0,0,0,0,0,0,0,0,0
1176,赵泳鑫,0,2,2,0,0.00233064,0.135912814,0,0,0,2,2
1177,万塘路号,1,0,1,0.001243008,0,0.134597348,0,0,1,0,1
1178,Rhab,0,0,0,0,0,0,0,0,0,0,0
1179,IRiS七叶,2,0,2,0.004251088,0,0.117660616,0,0,2,0,2
1180,Allfine,4,0,4,0.004317818,0,0.165010029,0,0,4,0,4
1181,魔幻之声口琴重奏团,0,1,1,0,0.001243008,0.131961382,0,0,0,1,1
1182,projectlights,0,0,0,0,0,0,0,0,0,0,0
1183,Elfar,0,1,1,0,0.00155376,0.113967694,0,0,0,1,1
1184,Rapen罗仁麒,0,0,0,0,0,0,0,0,0,0,0
1185,Yonetro,2,0,2,0.001864512,0,0.158372843,0,0,2,0,2
1186,推,0,1,1,0,0.001243008,0.133716187,0,0,0,1,1
1187,RachelChang,0,9,9,0,0.009089497,0.175511472,0,0,0,9,9
1188,慕斯の小乖,0,3,3,0,0.005422087,0.136252809,0,0,0,3,3
1189,MR-X,0,0,0,0,0,0,0,0,0,0,0
1190,MERA,0,0,0,0,0,0,0,0,0,0,0
1191,陶格斯,0,0,0,0,0,0,0,0,0,0,0
1192,郝云,4,0,4,0.00310752,0,0.14457083,0,0,4,0,4
1193,JunoReactor,0,0,0,0,0,0,0,0,0,0,0
1194,季彦霖,0,5,5,0,0.004620747,0.157457173,0,0,0,5,5
1195,许多葵,0,3,3,0,0.002486016,0.154261204,0,0,0,3,3
1196,Xerls,0,10,10,0,0.019439525,0.175558615,0,0,0,10,10
1197,孙翔,0,0,0,0,0,0,0,0,0,0,0
1198,泠鸢yousaの呆萌忆【管理团队】,0,1,1,0,0.001243008,0.131961382,0,0,0,1,1
1199,PurpleBattery,27,1,28,0.017402113,0,0.198905881,0,0,28,1,28
1200,XjMiracle,0,1,1,0,0.001243008,0.128763736,6,0,0,1,1
1201,金忻,0,0,0,0,0,0,0,0,0,0,0
1202,黄小琥,1,3,4,0.001243008,0.002486016,0.143177376,0,2.32E-06,1,3,4
1203,ElectronicDanceMusic,0,1,1,0,0.005046613,0.144411119,0,0,0,1,1
1204,宁桓宇,0,0,0,0,0,0,0,0,0,0,0
1205,MisTer说唱团,1,1,2,0.003029832,0.001243008,0.102494076,0,0,1,1,2
1206,NickLopez,0,1,1,0,0.001243008,0.13876958,0,0,0,1,1
1207,洛萱,0,0,0,0,0,0,0,0,0,0,0
1208,昭和三色_,0,4,4,0,0.003196306,0.159415786,0,0,0,4,4
1209,黄国俊,0,0,0,0,0,0,0,0,0,0,0
1210,胡夏,2,0,2,0.001864512,0,0.118514002,0,0,2,0,2
1211,丛铭君,1,1,2,0.001243008,0.001775726,0.142490674,0,0,1,1,2
1212,漆柚,10,0,10,0.007043712,0,0.174573911,0,0,10,0,10
1213,光泽,0,0,0,0,0,0,28,0,0,0,0
1214,Mason,0,0,0,0,0,0,0,0,0,0,0
1215,西瓜JUN,11,1,12,0.01029921,0.001243008,0.164016242,4,1.08E-05,11,1,12
1216,文子轩,0,0,0,0,0,0,0,0,0,0,0
1217,大张伟,4,1,5,0.00310752,0.001243008,0.174807361,0,1.55E-06,4,1,5
1218,MRUO,0,3,3,0,0.005611638,0.149088669,0,0,0,3,3
1219,熊猫眼乐队,0,1,1,0,0.001243008,0.118707723,0,0,0,1,1
1220,予词,0,2,2,0,0.001864512,0.001864512,0,0,0,2,2
1221,西原健一郎,0,0,0,0,0,0,0,0,0,0,0
1222,Diplo,0,0,0,0,0,0,6.95,0,0,0,0
1223,南游记乐队,1,0,1,0.001243008,0,0.109463193,0,0,1,0,1
1224,CloudINJoke,1,10,11,0.001243008,0.008940097,0.166184776,0,2.69E-06,1,10,11
1225,Yae_Angelica,0,2,2,0,0.001864512,0.12535572,0,0,0,2,2
1226,纪粹希,1,0,1,0.001243008,0,0.001243008,0,0,1,0,1
1227,尹毓恪,2,0,2,0.003196306,0,0.130930433,0,0,3,0,3
1228,佟妍,1,0,1,0.001243008,0,0.124805179,0,0,1,0,1
1229,Blacklist黑名单,2,0,2,0.001864512,0,0.148008316,0,0,2,0,2
1230,未完成乐队,1,0,1,0.001243008,0,0.001243008,0,0,1,0,1
1231,刘力扬,0,0,0,0,0,0,0,0,0,0,0
1232,周柏豪,3,0,3,0.002486016,0,0.155694312,0,0,3,0,3
1233,董又霖,0,0,0,0,0,0,0,0,0,0,0
1234,邓伦,0,0,0,0,0,0,0,0,0,0,0
1235,伏仪,2,0,2,0.001864512,0,0.137485217,0,0,2,0,2
1236,冯佳琪,0,0,0,0,0,0,0,0,0,0,0
1237,艾热,1,0,1,0.001243008,0,0.09651576,0,0,1,0,1
1238,天堂乐队,1,0,1,0.001243008,0,0.001243008,0,0,1,0,1
1239,江潮,0,2,2,0,0.001864512,0.083913817,0,0,0,2,2
1240,KIDPUNK,0,24,24,0,0.015537601,0.170564907,0,0,0,24,24
1241,Fran,0,7,7,0,0.008073145,0.165805359,0,0,0,7,7
1242,Jason王威登,0,0,0,0,0,0,0,0,0,0,0
1243,儿时玩具,0,1,1,0,0.001243008,0.145991674,0,0,0,1,1
1244,谢安琪,3,0,3,0.002486016,0,0.155139977,0,0,3,0,3
1245,鲍元恺,0,0,0,0,0,0,0,0,0,0,0
1246,纣王老胡,6,0,6,0.005386368,0,0.153608631,30,0,6,0,6
1247,大泫,0,0,0,0,0,0,0,0,0,0,0
1248,廖效浓,13,1,14,0.010582366,0.001243008,0.181204525,0,1.16E-05,13,1,14
1249,封茗囧菌,7,0,7,0.004972032,0,0.168802873,0,0,7,0,7
1250,PonySoore,7,0,7,0.005655687,0,0.172865571,0,0,8,0,8
1251,彭佳慧,2,0,2,0.001864512,0,0.149737623,0,0,2,0,2
1252,袁弘,15,0,15,0.015642941,0,0.175889323,0,0,15,0,15
1253,吆拐和吗子,1,0,1,0.001243008,0,0.001243008,0,0,1,0,1
1254,朴树,24,0,24,0.013996789,0,0.174201685,0,0,24,0,24
1255,TaikoSuperKicks,0,0,0,0,0,0,0,0,0,0,0
1256,平安,2,0,2,0.002175264,0,0.133470436,0,0,2,0,2
1257,弹棉花的GG,4,0,4,0.00310752,0,0.130564268,0,0,4,0,4
1258,cattz?m,0,3,3,0,0.002486016,0.15143761,272,0,0,3,3
1259,Heki,0,18,18,0,0.01839087,0.177900034,0,0,0,18,18
1260,坡上村,1,19,20,0.002130871,0.013523329,0.185314637,0,1.05E-04,1,19,20
1261,PSYKHON,3,0,3,0.002486016,0,0.114587083,0,0,3,0,3
1262,Nencol,0,2,2,0,0.00535355,0.142989439,0,0,0,2,2
1263,周玥,4,0,4,0.00310752,0,0.137629969,0,0,4,0,4
1264,青葉市子,0,0,0,0,0,0,0,0,0,0,0
1265,执纸大魔王,11,0,11,0.011378305,0,0.169767461,0,0,11,0,11
1266,ANK,0,1,1,0,0.001243008,0.145959072,7,0,0,1,1
1267,FromYourBalcony,0,0,0,0,0,0,0,0,0,0,0
1268,王宇良,1,2,3,0.001775726,0.001864512,0.137891292,0,2.71E-06,1,4,5
1269,慕容晓晓,1,0,1,0.001243008,0,0.125403823,0,0,1,0,1
1270,北岛诗,1,0,1,0.001243008,0,0.117406992,0,0,1,0,1
1271,ZOMBIE-CHANG,0,0,0,0,0,0,207,0,0,0,0
1272,深蓝儿童,0,1,1,0,0.001243008,0.095097443,0,0,0,1,1
1273,七手,1,3,4,0.00284856,0.005947558,0.138504921,0,8.01E-05,1,3,4
1274,GalenCrew,0,0,0,0,0,0,0,0,0,0,0
1275,前冲,0,25,25,0,0.020745181,0.181405696,0,0,0,25,25
1276,GHASTLY,0,0,0,0,0,0,0,0,0,0,0
1277,大贺兄弟,0,0,0,0,0,0,0,0,0,0,0
1278,贾盛强,0,0,0,0,0,0,85,0,0,0,0
1279,vDJs,2,0,2,0.004039776,0,0.166058111,0,0,2,0,2
1280,杨炅翰,2,8,10,0.00207168,0.009019388,0.155768523,0,3.29E-05,2,8,10
1281,ChocolatePuma,0,1,1,0,0.001243008,0.120369194,0,0,0,1,1
1282,小sa神,0,1,1,0,0.001243008,0.116217056,0,0,0,1,1
1283,活死人,0,1,1,0,0.001243008,0.123414789,0,0,0,1,1
1284,OLWIK,2,0,2,0.001864512,0,0.133089946,0,0,2,0,2
1285,谭维维,6,0,6,0.004039776,0,0.155546103,0,0,6,0,6
1286,Vicetone,0,0,0,0,0,0,0,0,0,0,0
1287,贺世哲,0,0,0,0,0,0,0,0,0,0,0
1288,LoveSong,0,0,0,0,0,0,0,0,0,0,0
1289,Jauz,0,0,0,0,0,0,0,0,0,0,0
1290,马博,0,0,0,0,0,0,0,0,0,0,0
1291,IZ乐队,0,0,0,0,0,0,0,0,0,0,0
1292,林和夜,0,1,1,0,0.001243008,0.10839216,0,0,0,1,1
1293,Fuyuki,0,0,0,0,0,0,0,0,0,0,0
1294,花粥,0,2,2,0,0.001864512,0.139301944,0,0,0,2,2
1295,REI泠千夜,0,9,9,0,0.007939213,0.16090712,0,0,0,9,9
1296,洛尘鞅_vvv,0,1,1,0,0.001243008,0.112612806,0,0,0,2,2
1297,印子月,0,0,0,0,0,0,0,0,0,0,0
1298,驳倒乐队,0,0,0,0,0,0,0,0,0,0,0
1299,刘旭阳,0,0,0,0,0,0,0,0,0,0,0
1300,靖佩瑶,0,1,1,0,0.001243008,0.131695491,0,0,0,1,1
1301,任东,0,3,3,0,0.008131573,0.15595436,0,0,0,3,3
1302,G.G(张思源),0,4,4,0,0.003418272,0.141106374,0,0,0,4,4
1303,贝歌,0,19,19,0,0.01379739,0.183906788,0,0,0,19,19
1304,熊汝霖,1,0,1,0.001243008,0,0.107553846,0,0,1,0,1
1305,CodeWu,0,0,0,0,0,0,0,0,0,0,0
1306,moumoon,0,0,0,0,0,0,2,0,0,0,0
1307,周蕙,0,0,0,0,0,0,0,0,0,0,0
1308,翁大涵,3,1,4,0.002486016,0.001243008,0.155472104,0,7.74E-07,3,3,6
1309,布瑞吉Bridge,0,0,0,0,0,0,0,0,0,0,0
1310,YoungMai,0,1,1,0,0.001243008,0.131695491,0,0,0,1,1
1311,小虫,0,0,0,0,0,0,0,0,0,0,0
1312,陈翔,0,0,0,0,0,0,0,0,0,0,0
1313,F.BING.KAI,0,2,2,0,0.005941852,0.154699343,15,0,0,2,2
1314,李想Evelyn,6,0,6,0.004350528,0,0.170609429,0,0,6,0,6
1315,YEHAIYAHAN,7,2,9,0.00525888,0.001864512,0.186212172,0,5.80E-06,7,2,9
1316,朱强,0,1,1,0,0.001243008,0.001243008,0,0,0,1,1
1317,Evalia,1,0,1,0.001243008,0,0.001243008,0,0,1,0,1
1318,Fi江澈,11,0,11,0.019963846,0,0.165218585,0,0,12,0,12
1319,situasian张太郎,1,0,1,0.002237415,0,0.116923922,0,0,1,0,1
1320,范小蛙,0,1,1,0,0.00155376,0.113828757,0,0,0,1,1
1321,Carta,0,2,2,0,0.005941852,0.157571052,0,0,0,2,2
1322,豆腐P,0,1,1,0,0.001243008,0.113670387,0,0,0,1,1
1323,江凯文,0,0,0,0,0,0,0,0,0,0,0
1324,谢容儿,0,1,1,0,0.001243008,0.109591671,0,0,0,1,1
1325,左小祖咒,8,0,8,0.005184253,0,0.165385811,0,0,8,0,8
1326,河图,9,0,9,0.008143846,0,0.15704102,0,0,9,0,9
1327,戴荃,0,0,0,0,0,0,0,0,0,0,0
1328,COREONE,0,0,0,0,0,0,0,0,0,0,0
1329,王强,0,0,0,0,0,0,0,0,0,0,0
1330,BING,0,0,0,0,0,0,0,0,0,0,0
1331,INVADE,0,1,1,0,0.001243008,0.114687616,0,0,0,1,1
1332,南无,0,0,0,0,0,0,0,0,0,0,0
1333,刘洋,1,0,1,0.002677248,0,0.142926902,0,0,1,0,1
1334,DoAsInfinity,0,0,0,0,0,0,0,0,0,0,0
1335,山人乐队,0,0,0,0,0,0,0,0,0,0,0
1336,$唐老师,0,1,1,0,0.001243008,0.001243008,0,0,0,1,1
1337,Ryzu,0,0,0,0,0,0,6.5,0,0,0,0
1338,李志,43,0,43,0.035338226,0,0.201171044,0,0,44,0,44
1339,赵传,1,4,5,0.001243008,0.003480423,0.15364474,0,2.52E-06,1,4,5
1340,To,0,1,1,0,0.001243008,0.144859203,4,0,0,1,1
1341,源君,0,1,1,0,0.001243008,0.001243008,0,0,0,1,1
1342,阿颖不说话,2,2,4,0.001864512,0.001864512,0.113749517,0,1.55E-06,2,2,4
1343,王三溥,4,0,4,0.00310752,0,0.142397543,0,0,4,0,4
1344,边际自由,0,0,0,0,0,0,0,0,0,0,0
1345,笛在月明楼,0,6,6,0,0.00466128,0.148411608,0,0,0,6,6
1346,Steerner,2,0,2,0.004039776,0,0.166058111,0,0,2,0,2
1347,韦星弟,0,0,0,0,0,0,0,0,0,0,0
1348,张阳阳,0,0,0,0,0,0,0,0,0,0,0
1349,MAKJ,0,0,0,0,0,0,0,0,0,0,0
1350,Sleepmakeswaves,0,0,0,0,0,0,0,0,0,0,0
1351,张渠,0,0,0,0,0,0,0,0,0,0,0
1352,Thunse,3,0,3,0.00483392,0,0.163975094,0,0,3,0,3
1353,何璟昕,2,0,2,0.001864512,0,0.10199824,0,0,2,0,2
1354,马子林Broma,2,0,2,0.00262944,0,0.123859148,0,0,2,0,2
1355,马旭东,0,2,2,0,0.001864512,0.15091312,0,0,0,2,2
1356,SWIN,0,0,0,0,0,0,0,0,0,0,0
1357,烛鷷大魔王,2,0,2,0.001864512,0,0.126962844,0,0,2,0,2
1358,AOA组合,1,0,1,0.001243008,0,0.001243008,0,0,1,0,1
1359,HeaMusic,0,1,1,0,0.001243008,0.145116502,0,0,0,1,1
1360,蔡小江,0,0,0,0,0,0,0,0,0,0,0
1361,Mario,0,0,0,0,0,0,0,0,0,0,0
1362,李上安,7,0,7,0.00656032,0,0.161184889,0,0,8,0,8
1363,韦礼安,0,3,3,0,0.002486016,0.149054669,0,0,0,3,3
1364,柯暮卿,0,0,0,0,0,0,0,0,0,0,0
1365,王诗安,0,0,0,0,0,0,0,0,0,0,0
1366,倪莫问,0,0,0,0,0,0,0,0,0,0,0
1367,孟大C,0,1,1,0,0.001243008,0.145991674,0,0,0,1,1
1368,BillySmith,0,3,3,0,0.006361277,0.155842805,0,0,0,3,3
1369,鱼果,0,3,3,0,0.002486016,0.130877998,0,0,0,3,3
1370,a$ce,0,3,3,0,0.007306872,0.155731409,0,0,0,6,6
1371,李玟,4,0,4,0.00310752,0,0.155694312,0,0,4,0,4
1372,王继阳,0,1,1,0,0.00138112,0.116155096,0,0,0,1,1
1373,莫凝,0,5,5,0,0.004021497,0.110611732,0,0,0,5,5
1374,verahuuu,0,1,1,0,0.001243008,0.145828809,0,0,0,1,1
1375,丝绒公路,0,0,0,0,0,0,0,0,0,0,0
1376,陈楚生,20,0,20,0.012161704,0,0.1616633,0,0,20,0,20
1377,宋捷,0,2,2,0,0.001864512,0.127856949,100.5,0,0,2,2
1378,许嵩,15,0,15,0.012781366,0,0.178385569,0,0,15,0,15
1379,冯佳界,6,19,25,0.004350528,0.012484125,0.182469214,0,3.89E-05,6,25,31
1380,康妮啊啊,0,6,6,0,0.006134846,0.158411227,0,0,0,6,6
1381,Lilith乐队,1,0,1,0.001243008,0,0.134597348,0,0,1,0,1
1382,NPC,0,1,1,0,0.004996646,0.148884903,8,0,0,1,1
1383,SAM努尔夏提,2,1,3,0.004215419,0.001243008,0.113987569,0,0,5,1,6
1384,潘辰,1,2,3,0.001657344,0.001864512,0.136966623,0,3.10E-06,1,2,3
1385,郭欣桐,0,0,0,0,0,0,0,0,0,0,0
1386,炎亚纶,0,0,0,0,0,0,0,0,0,0,0
1387,阿沁,0,0,0,0,0,0,0,0,0,0,0
1388,Redkey,0,1,1,0,0.00213642,0.121895696,0,0,0,1,1
1389,MC九局,0,0,0,0,0,0,0,0,0,0,0
1390,AvrilLavigne,15,0,15,0.010441268,0,0.166650873,0,0,15,0,15
1391,寇麟,0,0,0,0,0,0,0,0,0,0,0
1392,何玉林,0,1,1,0,0.001243008,0.13685191,0,0,0,1,1
1393,梦寒,0,4,4,0,0.007458048,0.145601409,0,0,0,4,4
1394,陈晓东,0,2,2,0,0.001864512,0.149122684,0,0,0,2,2
1395,Xomu,0,2,2,0,0.001864512,0.14774067,2,0,0,2,2
1396,武艺,1,0,1,0.001657344,0,0.117196472,0,0,1,0,1
1397,刘增瞳,1,1,2,0.001243008,0.001243008,0.141289391,0,7.74E-07,1,1,2
1398,ILLENIUM,0,0,0,0,0,0,0,0,0,0,0
1399,余柯,0,4,4,0,0.00310752,0.142521745,186,0,0,4,4
1400,双笙,0,0,0,0,0,0,0,0,0,0,0
1401,卡修Rui,8,9,17,0.006059664,0.006869255,0.166311634,0,7.20E-05,9,9,18
1402,孛儿只斤·包迪,0,3,3,0,0.002486016,0.158488051,0,0,0,3,3
1403,魏枫,0,2,2,0,0.003127569,0.146351259,0,0,0,2,2
1404,龙井说唱,0,0,0,0,0,0,0,0,0,0,0
1405,冬子,0,1,1,0,0.005553866,0.15324847,0,0,0,1,1
1406,LaidbackLuke,0,1,1,0,0.001243008,0.120369194,0,0,0,1,1
1407,郁乐队,1,0,1,0.001243008,0,0.09849378,0,0,1,0,1
1408,杨和苏KeyNG,5,0,5,0.003729024,0,0.15299736,0,0,5,0,5
1409,孙露,0,0,0,0,0,0,0,0,0,0,0
1410,ForceDefender（坚定捍卫乐队）,0,0,0,0,0,0,0,0,0,0,0
1411,Liberation,0,0,0,0,0,0,0,0,0,0,0
1412,Maroon,0,0,0,0,0,0,28,0,0,0,0
1413,Dreamtale,0,0,0,0,0,0,0,0,0,0,0
1414,AThree-Arslan,11,2,13,0.007458048,0.001864512,0.138740124,99,1.08E-05,11,5,16
1415,OO偶像男团,1,0,1,0.001243008,0,0.001243008,0,0,1,0,1
1416,茶小姐和熊先生,3,2,5,0.00367498,0.003729024,0.147374233,0,3.83E-05,3,2,5
1417,柯子颜,0,0,0,0,0,0,0,0,0,0,0
1418,BlastWayZ,0,1,1,0,0.001243008,0.114687616,0,0,0,2,2
1419,ManicSheep,0,0,0,0,0,0,0,0,0,0,0
1420,一棵小葱,0,2,2,0,0.007458048,0.141964536,0,0,0,2,2
1421,圈,0,1,1,0,0.001243008,0.117851555,0,0,0,1,1
1422,南方二重唱,0,0,0,0,0,0,0,0,0,0,0
1423,SevenGurusFamily,1,0,1,0.001243008,0,0.001243008,0,0,1,0,1
1424,RichBrian,0,0,0,0,0,0,0,0,0,0,0
1425,周云蓬,0,0,0,0,0,0,0,0,0,0,0
1426,FerryCorsten,0,0,0,0,0,0,0,0,0,0,0
1427,张尧,0,3,3,0,0.002486016,0.160275803,0,0,0,3,3
1428,ModernChildren,0,0,0,0,0,0,0,0,0,0,0
1429,木紫紫,0,1,1,0,0.008943595,0.135630779,0,0,0,1,1
1430,蘑菇兄弟,0,6,6,0,0.00573696,0.135462119,0,0,0,6,6
1431,孔兰兰,0,0,0,0,0,0,0,0,0,0,0
1432,BrunoMajor,0,0,0,0,0,0,0,0,0,0,0
1433,王力宏,12,0,12,0.008157241,0,0.172182488,0,0,12,0,12
1434,Liars,0,0,0,0,0,0,0,0,0,0,0
1435,董昊,0,1,1,0,0.001243008,0.152961555,0,0,0,1,1
1436,Wiwek,0,2,2,0,0.001864512,0.128941551,0,0,0,2,2
1437,谭佑铭,0,0,0,0,0,0,0,0,0,0,0
1438,孟慧圆,0,5,5,0,0.005998865,0.156402183,0,0,0,5,5
1439,上海彩虹室内合唱团,11,0,11,0.008582675,0,0.166353964,0,0,11,0,11
1440,陈芳语,0,0,0,0,0,0,0,0,0,0,0
1441,USAGii,0,0,0,0,0,0,0,0,0,0,0
1442,OB,0,2,2,0,0.001631448,0.139808497,0,0,0,2,2
1443,Dassnae,1,0,1,0.001243008,0,0.139838409,0,0,1,0,1
1444,Shang,0,3,3,0,0.002047307,0.158296131,0,0,0,3,3
1445,李佳思,0,3,3,0,0.002486016,0.131589435,0,0,0,8,8
1446,CMCB,0,0,0,0,0,0,0,0,0,0,0
1447,佛山DJ明仔,0,0,0,0,0,0,0,0,0,0,0
1448,EasyMind,0,5,5,0,0.006563083,0.165931638,0,0,0,5,5
1449,PoKeR,0,0,0,0,0,0,0,0,0,0,0
1450,NL不分,0,1,1,0,0.001243008,0.136794626,0,0,0,1,1
1451,阮以伟,0,1,1,0,0.001243008,0.114768169,0,0,0,1,1
1452,杜婧荧,1,0,1,0.001243008,0,0.122558546,0,0,1,0,1
1453,苑笙,0,1,1,0,0.001243008,0.131695491,0,0,0,1,1
1454,娄艺潇,1,0,1,0.001243008,0,0.125403823,0,0,1,0,1
1455,陈鹏杰,0,3,3,0,0.002663589,0.142366527,0,0,0,3,3
1456,未来星BRich,0,2,2,0,0.001864512,0.145310076,0,0,0,2,2
1457,ANNER,0,0,0,0,0,0,218,0,0,0,0
1458,考拉抱树,0,8,8,0,0.005593536,0.144443033,141,0,0,8,8
1459,孟庭苇,1,4,5,0.002343958,0.0071712,0.168108211,0,8.44E-05,1,4,5
1460,大龙小龙DLXL,3,2,5,0.013201603,0.001775726,0.139868334,0,5.46E-05,3,2,5
1461,LCT,0,0,0,0,0,0,0,0,0,0,0
1462,Lauv,14,0,14,0.009322561,0,0.177320869,0,0,14,0,14
1463,鑫哥,0,0,0,0,0,0,0,0,0,0,0
1464,大庆小芳,0,0,0,0,0,0,0,0,0,0,0
1465,薛之谦,24,0,24,0.021368206,0,0.187386675,0,0,25,0,25
1466,玛雅,0,0,0,0,0,0,0,0,0,0,0
1467,刘家昌,0,0,0,0,0,0,2,0,0,0,0
1468,秋仁,0,3,3,0,0.004134353,0.15217805,0,0,0,3,3
1469,权振东,2,1,3,0.001864512,0.001243008,0.139898271,0,7.74E-07,2,1,3
1470,徐秉龙,6,0,6,0.004021497,0,0.167590955,0,0,7,0,7
1471,二夫,0,2,2,0,0.001864512,0.146877466,0,0,0,2,2
1472,BackToBand,1,0,1,0.001243008,0,0.15444346,0,0,1,0,1
1473,张希,0,3,3,0,0.006109252,0.162912444,0,0,0,3,3
1474,MissMass,0,1,1,0,0.001243008,0.123531416,0,0,0,1,1
1475,Rich哈木-,0,2,2,0,0.006080256,0.141442269,60.5,0,0,3,3
1476,KT,0,3,3,0,0.002355173,0.153212547,0,0,0,3,3
1477,彭青,3,6,9,0.002677248,0.005102875,0.159182836,6,2.34E-05,3,7,10
1478,塔斯肯,0,4,4,0,0.003196306,0.163278722,0,0,0,4,4
1479,弦子,2,3,5,0.001864512,0.002486016,0.145991674,0,2.32E-06,2,3,5
1480,李代沫,0,1,1,0,0.001243008,0.128992446,0,0,0,1,1
1481,Pianoboy高至豪,1,0,1,0.001243008,0,0.126081158,0,0,1,0,1
1482,OliviaOng,0,0,0,0,0,0,0,0,0,0,0
1483,飞翔,0,0,0,0,0,0,0,0,0,0,0
1484,痴人,0,1,1,0,0.001243008,0.148479038,0,0,0,1,1
1485,Pancakelee,0,2,2,0,0.001864512,0.148411608,187,0,0,2,2
1486,汪睿,0,2,2,0,0.001864512,0.129915469,0,0,0,2,2
1487,AY楊佬叁,24,1,25,0.020583145,0.001243008,0.178727023,0,7.24E-05,24,1,25
1488,蒋明,1,0,1,0.001243008,0,0.135518292,0,0,1,0,1
1489,太阳部落,0,0,0,0,0,0,0,0,0,0,0
1490,Flo,0,0,0,0,0,0,0,0,0,0,0
1491,LNYTNZ,0,0,0,0,0,0,0,0,0,0,0
1492,阿尔达克,0,4,4,0,0.005198034,0.166821012,0,0,0,4,4
1493,T-Tone_小T,0,1,1,0,0.001243008,0.125524241,0,0,0,1,1
1494,奶昔,0,1,1,0,0.001243008,0.141136844,0,0,0,1,1
1495,安神,0,0,0,0,0,0,0,0,0,0,0
1496,缦珠莎桦,0,1,1,0,0.001243008,0.099347123,22.5,0,0,1,1
1497,牛骏峰,0,0,0,0,0,0,0,0,0,0,0
1498,MusikM,1,12,13,0.001243008,0.008940097,0.187601815,90.533,8.71E-06,1,12,13
1499,陈每文,0,0,0,0,0,0,0,0,0,0,0
1500,ARSANAL,3,23,26,0.002663589,0.017658403,0.188196004,0,3.50E-05,3,23,26
1501,CheatCodes,0,0,0,0,0,0,0,0,0,0,0
1502,爽子,0,0,0,0,0,0,0,0,0,0,0
1503,翁梓铭,0,2,2,0,0.001864512,0.152568796,0,0,0,2,2
1504,妮可酱,0,0,0,0,0,0,0,0,0,0,0
1505,尤沫Dina,1,0,1,0.001243008,0,0.116134457,0,0,1,0,1
1506,Thexx,0,0,0,0,0,0,0,0,0,0,0
1507,森川ちよ,0,1,1,0,0.001243008,0.115335226,0,0,0,1,1
1508,黄玠玮ZooeyWonder,0,0,0,0,0,0,0,0,0,0,0
1509,DJAcey,0,0,0,0,0,0,0,0,0,0,0
1510,风子,7,0,7,0.004972032,0,0.165931638,0,0,8,0,8
1511,SanHolo,0,0,0,0,0,0,0,0,0,0,0
1512,Jokerone,0,0,0,0,0,0,0,0,0,0,0
1513,SNH,1,0,1,0.001243008,0,0.15444346,0,0,1,0,1
1514,冯家妹,0,0,0,0,0,0,0,0,0,0,0
1515,Gammer,0,1,1,0,0.001243008,0.151648428,0,0,0,1,1
1516,CoolCool小飞,0,0,0,0,0,0,0,0,0,0,0
1517,曹寅,0,13,13,0,0.009083521,0.175417263,0,0,0,13,13
1518,安苏羽,0,0,0,0,0,0,0,0,0,0,0
1519,浅蓝,0,0,0,0,0,0,0,0,0,0,0
1520,齐秦,2,0,2,0.001864512,0,0.140138234,0,0,2,0,2
1521,南风（姜海龙）,0,0,0,0,0,0,0,0,0,0,0
1522,陈信喆,0,0,0,0,0,0,0,0,0,0,0
1523,再循环乐队,1,0,1,0.001243008,0,0.134597348,0,0,1,0,1
1524,Lamp,0,0,0,0,0,0,0,0,0,0,0
1525,祖娅纳惜,1,0,1,0.002796768,0,0.141534154,0,0,1,0,1
1526,刘瑞琦,0,0,0,0,0,0,0,0,0,0,0
1527,Saiakoup,4,0,4,0.00310752,0,0.165010029,0,0,4,0,4
1528,琪叔,0,0,0,0,0,0,0,0,0,0,0
1529,韩庚,0,0,0,0,0,0,0,0,0,0,0
1530,金池,1,0,1,0.001243008,0,0.137600994,0,0,1,0,1
1531,宗儒,0,0,0,0,0,0,0,0,0,0,0
1532,刘思涵,0,3,3,0,0.002486016,0.154956075,0,0,0,4,4
1533,宇西,0,1,1,0,0.001243008,0.143271531,0,0,0,1,1
1534,ReDor锐豆乐队,1,0,1,0.001864512,0,0.143617825,0,0,1,0,1
1535,张怡诺,0,0,0,0,0,0,0,0,0,0,0
1536,向日葵乐队,2,0,2,0.003803605,0,0.146318496,0,0,2,0,2
1537,小灰,0,1,1,0,0.001243008,0.145991674,0,0,0,1,1
1538,秦兽,0,4,4,0,0.010170066,0.146943508,0,0,0,4,4
1539,朱婧汐JING,1,0,1,0.002677248,0,0.141902893,0,0,1,0,1
1540,兔子牙,0,0,0,0,0,0,0,0,0,0,0
1541,习谱予,12,0,12,0.009529729,0,0.185735926,0,0,12,0,12
1542,BrunoMars,0,0,0,0,0,0,0,0,0,0,0
1543,凑诗,2,0,2,0.001864512,0,0.125886888,0,0,2,0,2
1544,马丁,0,1,1,0,0.001243008,0.116217056,1,0,0,1,1
1545,黑豹乐队,2,0,2,0.001864512,0,0.16266917,0,0,2,0,2
1546,丁少华,2,1,3,0.001864512,0.001243008,0.153753169,0,3.87E-07,2,1,3
1547,梦璟SAYA,0,0,0,0,0,0,0,0,0,0,0
1548,Fcyco,13,0,13,0.010441268,0,0.160986385,0,0,14,0,14
1549,蔡健雅,18,0,18,0.020896513,0,0.193545965,0,0,18,0,18
1550,黄绮珊,2,0,2,0.00207168,0,0.121375065,0,0,2,0,2
1551,邱霖BigL,0,1,1,0,0.001243008,0.087980175,0,0,0,1,1
1552,AirJordy,3,0,3,0.004917988,0,0.167462138,0,0,3,0,3
1553,RED红八,0,1,1,0,0.00155376,0.113967694,0,0,0,1,1
1554,赫和美罗,0,1,1,0,0.001243008,0.116217056,1,0,0,1,1
1555,ShowMeTheParty,0,3,3,0,0.006282595,0.156514541,0,0,0,3,3
1556,警哥组合,1,1,2,0.001243008,0.001243008,0.158142928,0,3.87E-07,1,1,2
1557,猫叶叶,0,4,4,0,0.00310752,0.167590955,0,0,0,4,4
1558,孙悦,2,0,2,0.003770458,0,0.143460211,0,0,2,0,2
1559,冯圣雅,0,1,1,0,0.001243008,0.133716187,0,0,0,1,1
1560,阿振,0,0,0,0,0,0,0,0,0,0,0
1561,艾菲,0,0,0,0,0,0,0,0,0,0,0
1562,OwlCity,0,0,0,0,0,0,0,0,0,0,0
1563,留声玩具,4,0,4,0.00310752,0,0.142087983,0,0,4,0,4
1564,丁浩然,0,0,0,0,0,0,0,0,0,0,0
1565,任向东,0,1,1,0,0.001243008,0.124023667,0,0,0,1,1
1566,力量之声(VocalForce),0,0,0,0,0,0,0,0,0,0,0
1567,国风Dom.T,0,5,5,0,0.00379808,0.141197823,0,0,0,5,5
1568,范世錡,0,0,0,0,0,0,0,0,0,0,0
1569,小皮,0,6,6,0,0.009685105,0.171910764,0,0,0,6,6
1570,宋冬野,29,0,29,0.022809729,0,0.192803753,0,0,37,0,37
1571,DJLayDiMusic,0,1,1,0,0.001243008,0.128687679,1,0,0,1,1
1572,重庆孩子,0,1,1,0,0.001243008,0.125067877,0,0,0,1,1
1573,畸形儿-DeformedBoi,1,1,2,0.001243008,0.001243008,0.111746405,0,3.87E-07,1,1,2
1574,苏勒亚其其格,0,0,0,0,0,0,0,0,0,0,0
1575,裘繼戎子千,0,1,1,0,0.001243008,0.001243008,0,0,0,1,1
1576,何洁,1,0,1,0.001243008,0,0.15444346,0,0,1,0,1
1577,Anzar,2,0,2,0.001864512,0,0.118707723,9,0,2,0,2
1578,言和,0,0,0,0,0,0,0,0,0,0,0
1579,陆虎,3,1,4,0.003290316,0.001243008,0.134902936,0,3.48E-06,3,1,4
1580,徐海俏,0,0,0,0,0,0,0,0,0,0,0
1581,鬼否,4,0,4,0.00631215,0,0.158911919,0,0,4,0,4
1582,人衣大人,1,0,1,0.001243008,0,0.11778784,0,0,1,0,1
1583,耳光乐队,1,0,1,0.001243008,0,0.001243008,0,0,1,0,1
1584,裂天,0,3,3,0,0.003729024,0.132148145,0,0,0,3,3
1585,曹方瑞,0,0,0,0,0,0,0,0,0,0,0
1586,Nightsky,0,1,1,0,0.008427008,0.145763765,0,0,0,1,1
1587,李旭,0,2,2,0,0.001864512,0.14740747,2,0,0,2,2
1588,Frankmusik,0,0,0,0,0,0,0,0,0,0,0
1589,廖佳琳,1,2,3,0.001243008,0.001864512,0.137514143,0,7.74E-07,1,2,3
1590,机械懒猫,0,1,1,0,0.001243008,0.124259453,0,0,0,1,1
1591,暖乐团,0,0,0,0,0,0,0,0,0,0,0
1592,简吟,0,1,1,0,0.004866693,0.131934744,0,0,0,2,2
1593,AfraCheng,0,1,1,0,0.001243008,0.115928472,0,0,0,1,1
1594,李俊毅,0,2,2,0,0.001864512,0.147941314,3,0,0,2,2
1595,吉克隽逸,0,2,2,0,0.001864512,0.140681172,0,0,0,2,2
1596,许飞,3,1,4,0.002486016,0.001243008,0.132308648,0,1.16E-06,3,1,4
1597,唐宁,4,0,4,0.00632128,0,0.145601409,0,0,4,0,4
1598,程思佳,0,0,0,0,0,0,0,0,0,0,0
1599,贰婶,6,0,6,0.004350528,0,0.161145149,0,0,6,0,6
1600,塔罗乐团,0,0,0,0,0,0,0,0,0,0,0
1601,谣乐队,2,0,2,0.001864512,0,0.138504921,0,0,2,0,2
1602,韩沐伯,0,3,3,0,0.006282595,0.164553052,0,0,0,3,3
1603,潘云峰,0,1,1,0,0.003231821,0.113335308,0,0,0,3,3
1604,窦佳嫄,0,0,0,0,0,0,0,0,0,0,0
1605,檀烧,2,0,2,0.001864512,0,0.132954582,0,0,2,0,2
1606,riza,0,7,7,0,0.009175362,0.172046518,0,0,0,7,7
1607,HangOnTheBox挂在盒子上,0,2,2,0,0.001864512,0.134763861,0,0,0,2,2
1608,杨坤,1,0,1,0.001243008,0,0.127408328,0,0,1,0,1
1609,白菜,0,2,2,0,0.001864512,0.129298659,0,0,0,2,2
